重渡沟尚客优品	重渡沟尚客优
广西贺州火车票	广西贺州火车站
杭州悦榕庄套餐	杭州悦榕庄酒店
夜鸣沙	夜鸣沙套票
温江智选	温江智选假日
上海东方明珠门票不排队	上海东方明珠一日不排队
重庆出发大理	重庆出发大理自由行4天三晚
周口市	河南省周口市
4韩国旅游哈尔滨出发	韩国哈尔滨
三亚景点接送	三亚市区免费景点
伦敦签证 重庆	英国重庆签证
蛇口一珠海船票	珠海蛇口船票
上海迪士尼乐园花车	上海迪士尼乐园花车巡游
泰国甲米自由行	甲米自由行
大理双廊馨海悦客栈	大理双廊海悦客栈
重庆大学城西部客运站酒店	重庆大学城酒店
钓鱼 北京	北京钓鱼
上海虹桥行李寄存	上海虹桥行李
民宿台州	台州 民宿
油坊桥(地铁站)	油坊桥
全季上海虹桥机场酒店	全季上海虹桥枢纽空港酒店
港澳门通行证	珠海澳门港澳通行证
张家口蓝鲸大厦	张家口蓝鲸大厦张家口蓝鲸酒店
黄石市阳新县仙岛湖风景区	湖北黄石阳新县仙岛湖酒店
 长沙酒店	长沙的酒店 
南京三山街附近酒店	南京地铁三山街站附近的酒店
wifi埃及土耳其迪拜	迪拜埃及wifi
周宁酒店	周宁的酒店
驿云精品客栈大明山	驿云精品客栈大明山峪涧店
徐州到广州飞机	广州至徐州飞机
驻马店酒店	驻马店的酒店
济宁斯维登	济宁斯维登酒店
故宫半日	故宫 半日
成都出发周边4日游	成都周边三日
莲花山攻略	莲花山自由行
广西梯田自由行	广西 梯田
泰国自由自由行	杭州出发泰国自由行
南京夜市	南京旅游夜市
滑雪场兰州	兰州滑雪
如家快捷酒店厦门中山路步行街	如家酒店厦门中山路步行街
悦尚酒店	悦尚
暹罗广场附近美食	暹罗广场附近自助午餐
北京北海公园 联票	北京北海公园门票
泉州泉港区	泉州市泉州站酒店
常州景尚恐龙园主题酒店2晚	常州环球恐龙城景尚
郑州方特欢乐世界快速通行证	郑州方特欢乐世界学生票
广州长隆三人床	广州长隆三人
联通无忧行境外流量包香港	香港无忧行境外流量包
长沙市湘一立信实验学校	长沙市湘雅医学院
H套餐珠海长隆横琴湾酒店家庭套票	珠海长隆横琴湾酒店家庭套餐
新宿购物攻略	新宿购物自由行
北京原著悦	北京原著
南京珍宝假日饭店百家湖店	南京珍宝假日酒店（江宁百家湖地铁站店）
峨眉山往返大巴	峨眉山大巴
hotel35	HOTEL35
泰国按摩保健店	按摩泰国
青岛 海景花园	青岛海景花园酒店
武汉的亚朵酒店	武汉亚朵酒店
泗洪到泗县	泗阳到泗洪
多次入台证	入台证，
上海艾享酒店	艾享酒店上海
苏梅岛用车	接机苏梅岛
青岛 潜水	青岛潜水体验
春秋航空行李额度	春秋航空手提行李额购买
厦门船票鼓浪屿	厦门鼓浪屿船票
正阳到平顶山	南阳到平顶山
维多利下港	维多利亚港
大理黄金海岸	大理双廊黄金海岸
汉庭昆明市体育馆酒店	汉庭酒店(昆明市体育馆地铁站店)
亚特兰蒂斯失落的空间水族馆自助餐	亚特兰蒂斯失落的空间水族馆水族馆门票
广州长隆野生动物园门票 满减	广州长隆野生动物园门票双人
衡阳莲湖广场	衡阳南华附二医院
刘家峡农家乐	甘肃刘家峡农家乐
南澳岛附近的酒店	南澳酒店
成都地铁旅游攻略	成都旅游攻略
嘉兴温泉度假村	嘉兴温泉酒店
南昌万达乐园通票	南昌万达主题乐园门票多少钱
厦门市厦门国际会议展览中心酒店	厦门国际酒店 会展中心
梵净山带凤凰	凤凰梵净山
福建光大国际旅行社	福建光大国际旅行社专营店
曲阜市曲阜师范大学酒店	曲阜师范大学住宿
南宁按摩会所	南宁水疗
德国签字	德国签证
贵阳亨特城市广场	贵阳亨特城市广场酒店
青岛涝山	山青岛
千岛湖喜来登度假公寓	杭州千岛湖喜来登度假酒店
汉庭天津卫国道	（新品）汉庭天津卫国道酒店
威海市环翠区	威海环翠区酒店
泰州药城锦江之星	锦江之星品尚泰州医药城酒店
南京逸扉	南京逸扉酒店
流量卡 澳门	澳门手机上网卡4g
济宁任城区酒店	济宁市任城区
重庆荣昌初级中学	重庆铁路中学
广州从化碧水湾	从化碧水湾酒店
金凤凰	金凤凰国际酒店
腾冲民宿客栈	腾冲名宿
黄村酒店	黄 村 酒店
无锡火车站北广场	无锡火车站
青岛维多利亚丽雅海景酒店公寓	青岛维多利亚海景花园公寓
六安诺言法式旅馆北大街店	六安诺言法式旅馆东大街店
敦煌四天三晚	敦煌四日
双十一大卖	双十一大促
仙本那酒店	仙本那沙滩酒店
舒克舒克酒店（深圳宝安国际机场店）	舒克舒克酒店深圳
南昭风情岛	南诏风情岛
太白山景区内酒店	太白山住宿
厦门租车跑车	厦门租车豪车
赣州市当地玩乐	赣州温泉
河源火车站	河源汽车站
三亚的亚龙湾酒店	三亚的酒店亚龙湾
建安区第一高级中学	建安区
普吉潜水 ow	普吉岛潜水考证
香港太平蜡像馆	香港蜡像馆
伊犁福寿山玻璃桥	伊犁福寿山
咸阳机场城际	咸阳机场 
有马温泉 合肥	有马汤泉合肥
昆明到保山的火车	保山到昆明火车票
广州长隆欢乐世界跟团	广州长隆欢乐世界团
上海 游泳	上海游泳
卡斯迪精品酒店	卡斯迪酒店
张家界青年旅舍离火车站近	张家界火车站青年旅舍
西宁金桥宾馆（小桥店）	西宁金桥宾馆
四季阳光精品酒店	四季阳光酒店
境外流量包印度尼西亚(中国移动)	【东南亚等53国通用】印度尼西亚流量包-中国移动
厦门植物园	厦门 植物 园
青海湖名宿	青海湖周边民宿
泉州湖美之星精品酒店	泉州湖美之星酒店
杭州茶叶博物馆附近的酒店	杭州江南专修学院酒店
锦江之星风尚西安	西安锦江之星风尚
上海淮海路附近的酒店	上海淮海西路
大学城如家	如家 大学城
香港 随身wifi	移动wifi香港
三峡人家和神农架	三峡人家神农架
山西大同跟团	大同旅游团
珠海市体育中心附近的酒店	珠海市体育中心东门
成都新南门民宿	成都东站附近民宿
灵山洞景区	灵山洞
日照跟团亲子游	日照跟团游
西塘花田别院酒店	嘉兴西塘花田别院
廊坊佰元快捷酒店(和平路店)	廊坊佰元快捷酒店新开路店
湖北2日游	湖北省内2日游
上海  迪士尼 套票	上海迪士尼套餐
三亚亚龙湾天域度假酒店含机票	三亚亚龙湾天域度假酒店5晚
上海南京温泉一日游	上海温泉一日
威海冰雪大世界	威海冰雪
湖北民族大学	湖北师范大学
德州私人影院	德州电影院
桃源汽车站	桃源火车站
曼谷拜约克摩天塔自助餐 自由兔	曼谷拜约克摩天塔自助餐
深圳蛇口至珠海船票	珠海九洲港到深圳市蛇口船票
无锡太湖鼋头渚攻略	无锡太湖鼋头渚自由行
安顺客运东站附近酒店	安顺火车站附近的酒店
宝鸡和佳时尚酒店	宝鸡和佳时尚酒店（英达路店）
三亚包车一日游	三亚一日游包车
曲府孔庙门票	曲阜孔庙门票
华崟山旅游门票	华崟山门票
海洋王国附近	海底世界
晋冠客栈	晋客栈
新塘客运站	新塘南站
沈阳有几个火车站	沈阳火车站
湖州飞鸿滑草乐园	湖州飞鸿滑草
惠州檀悦公寓	惠州檀悦酒店
如家公寓酒店 西安高新科技区	西安如家酒店高新科技
水月逸酒店	水月逸
澳门  塔	澳门塔
贵阳凯兵斯基	贵阳凯宾斯基
马鞍山金鹰国际	马鞍山金鹰
千岛湖土豆农庄标准间	千岛湖土豆农庄
无锡车站	无锡火车站附近酒店宾馆
迪士尼家庭套票	迪士尼家庭票
碧水湾门票	碧水湾一日
环抚仙湖租车	抚仙湖租车
珠海花漾酒店	珠海花漾
朱大商务快捷酒店	快捷商务酒店
阿里9日游	阿里 9日
阳朔如期民宿	阳朔如期.精品民宿（西街店）
火车站民宿	民宿火车站
汕头市金平区附近酒店	汕头市金平区酒店
拉萨暮野晨歌青年旅舍	拉萨暮野晨歌青年旅社久号店
悦来精品民宿	悦来居民宿
宜春温汤镇附近的酒店 泡池	宜春温汤镇酒店
鹭岛·湖畔酒店	鹭岛湖畔
龙岩闽西交易城附近的酒店	龙岩闽西职业学院附近的酒店
泰顺到温州	温州到泰顺
小海龟接送机	海龟接送机
环球影城实体票	环球影城vip门票
山西省太原博物馆	太原地质博物馆
迪拜埃及电话卡	埃及电话卡4g旅游手机卡 etisalat高速流量上网卡 可选通话
花青宿厦门	厦门花青宿
长春九台区酒店	长春九十中学酒店
筑梦居公寓	筑梦公寓
昆明高原明珠大酒店	昆明高原明珠大酒店双桥店
信阳出发跟团游一日	信阳跟团游
兰州甘肃省中医学院附近的酒店	兰州甘肃省肿瘤医院酒店
离北京人民大会堂较近的宾馆	北京人民大会堂附近的酒店
手机卡欧洲	欧洲流量卡
大同的主题酒店	大同主题
台州温岭市石塘栖衡石舍	台州温岭石塘
延安窑洞酒店	延安窑洞宾馆
广州民宿天河	广州天河区名宿
福州恒盛	福州恒盛酒店
保定集瀚考试中心	保定市集瀚考试中心
格锦江之星大连	锦江之星大连
东莞常平隐贤山庄门票套票双	东莞常平隐贤山庄门票套票酒店
smart	Smart
福建厦门三日游	厦门跟团三天两晚泉州出发
青龙湾原生态旅游度假区	青龙湾生态旅游区
天玺精品酒店	天玺
广州长隆水世界门票	广州长隆水上乐园水世界
土耳其跟团游纯玩成都	土耳其纯玩跟团游
兰州包车游	兰州按日包车
西安至成都快铁	成都东到西安高铁
杭州到青岛往返	杭州到青岛机票
北疆4天	北疆四日
澳门周边	澳门周边游
三亚美食街	三亚亚龙湾美食街
故宫预约	故宫门票预订
北京出发京都自由行4天	成都北京四日自由行
青岛长歌行	长歌行青岛
阳澄之星商旅酒店	阳澄之星
冬天新疆旅游	新疆冬游
珠海长隆海企鹅酒店	珠海长隆 企鹅酒店
洱海边海景房	洱海 边 海景 房
昆明万合旅游国贸专营店	昆明万合国旅国贸专营店
新郑T2	新郑t2航站楼酒店
泰国单地接	泰国地接
上海迪士尼跟团高铁	上海 迪士尼 跟 团 高铁
毛里求斯北部半日游	毛里求斯北部一日
大理龙之旅旅行社一日游	大理一日游纯玩龙之旅
深圳航空公司基地	深圳航空公司
爱上电竞酒店	爱电竞酒店
重庆渝中区儿童医院酒店	重庆市渝中区儿童医院最近酒店
上海人民广场 汉庭酒店	汉庭酒店上海人民广场
速8酒店合肥莲花路店	速8酒店合肥铭传路店
三亚别墅整栋	三亚小别墅
惠州宝安红海湾酒店海南	惠州宝安红海湾酒店
三亚跟团游私 团	三亚游跟团跟团游
潍坊图越	潍坊图越艺术酒店
武汉到西安旅游	武汉到西安自由行
江西南昌万达主题乐园门票	南昌万达乐园门票
夜游乌镇	乌镇夜景一日游
美娜多潜水	美娜多潜水考证
华美达香港	香港华美达
斯里兰卡租车	斯里兰卡 租车
丽江的青年旅舍	青旅丽江
三亚丽思卡尔顿早餐	三亚丽思卡尔顿自助餐
北京海花园饭店	花园饭店北京
维也纳酒店青湖店	维也纳酒店青
西欧洲4g电话卡	欧洲电话卡4g无限
伊宁的酒店	伊宁 酒店
古北水镇承德避暑山承德庄乌兰布统	古北水镇承德避暑山庄乌兰布统
如家联盟华驿酒店国贸	如家联盟华驿酒店
济南天桥区酒店	济南市天桥区
伯尔曼	伯尔曼艺术酒店
敦煌大环线包车	敦煌包车拼车
蔓兰酒店九华山	九华山 蔓兰酒店
涠洲岛随风	北海涠洲岛白房子花园海景酒店
惠州第三人民医院	惠州市第一人民医院
新开业酒店	新开业的酒店
南京 游乐场	南京乐园
南京大学鼓楼区	南京大学附近酒店
三亚艾迪逊酒店套餐	三亚艾迪逊酒店旗舰店
吉安电竞	吉安电竞酒店
天津方特夜场票	天津方特欢乐世界夜场票
施秉黑冲大酒店	施秉黑冲酒店
扎尕那 青年	扎尕那青年
九江火车站到庐山风景区	九江站怎么到庐山
河南省郑州市金水区	郑州金水区
济宁曲阜东站酒店	济宁曲阜师范大学酒店
太原和乔家大院一日游	太原乔家大院一日
朱家尖竹熹清舍	朱家尖竹熹
崇州云上	崇州云上酒店
韩国签证深深圳出发	韩国签证深圳
民丹岛酒店	民丹岛residence
千岛湖一日游纯玩	千岛湖纯玩
蜈支洲岛 门票	蜈支洲门票
泰国摄影	泰国约拍
大角湾附近的酒店	大角湾酒店
大鹏玫瑰海岸别墅小区洋房	深圳大鹏玫瑰海岸酒店
深圳龙华希尔顿逸林	深圳龙华希尔顿逸林酒店
天眼包车	包车天眼
北海看日出	北海日出
上海汽车城附近酒店	上海汽车博物馆附近的酒店
泸沽湖拼车环岛	泸沽湖环湖车
外伶仃岛3天2夜	外伶仃岛三天两晚
大兴机场地铁站	 大兴机场
龙门县酒店	龙门县
山西跟团游4天3晚	山西4日游
北海到南宁的动车票	南宁到北海
湖州木食	湖州木食民宿
昆明景点	昆明民族村门票
南京酒店希尔顿	南京 希尔顿
二日一三日游	三亚二日游
衢州百年尚庭精品酒店	衢州佰年尚庭酒店
斜源民宿	斜源镇民宿
贵州乐游旅行社专营店	贵州定制游
西北政法长安校区附近	西北大学长安校区
香港地铁卡两日卡	香港地铁卡二日
弥勒温泉单独泡池	弥勒室内温泉
广州长隆欢乐世界跟团游	广州长隆欢乐世界跟团
温州 泰国签证	泰国温州
长沙民宿五一广场亲子	长沙民宿五一广场民宿
宁德景点	福建宁德旅游景点
轰趴青岛	青岛独栋别墅
洛克岛浮潜	洛克 岛 浮潜
吉林市松花湖门票	吉林市一日游松花湖
希尔顿欢朋青岛	青岛希尔顿酒店
大理洱海酒店民宿	大理古城洱海附近海景民宿
如家李沧	如家酒店李沧
福州海峡奥体中心附近酒店	福州海峡国际会展中心酒店
顺德玛雅海滩水上乐园	顺德玛雅水上乐园
上好人家	上好人家商务酒店
彭山北站到成都	彭山北到成都
黄山3天2晚自由行	黄山自由行3天2晚双人
郑州二日游旅游攻略	郑州二日游
武汉马可波罗大酒店	马可波罗酒店武汉
信阳市罗山县灵山	信阳市罗山县灵山寺
贵港市达开高级中学附近	贵港达开高级中学
鼎湖区的酒店	鼎湖区
北京德宝酒店	北京西直门德宝
万纳清雅	万纳清雅酒店
日照旅游全称服务	日照旅游服务
张家界景区酒店	张家界国家森林公园景区内酒店
东京海洋	东京 海洋
惠州万科双月湾银	双月湾惠州万科
爽wifi	wifi
长沙五一广场酒店往后余生	长沙余生有你
北京欢乐谷的门票	北京欢乐谷大门票
百合公寓酒店	百合公寓
北裁河长城号游船	长城号海上游船
citigo欢阁	欢阁citigo
杭州到北京旅游	杭州到北京的
泰国跟团旅行	泰国跟团半自由行
泰国电话卡。	泰国happy卡
元阳梯田住宿	元阳梯田酒店
三亚一价全包酒店春节	三亚双十一酒店套餐
成都 春熙路	成都春熙路附近酒店
桂林阳朔兴坪古镇	阳朔兴坪古镇
上海徐汇区武康路酒店	上海武康路
宜昌到重庆船票	宜昌到重庆的船票
南湾岛一日游	南湾一日
宜昌 重庆	重庆宜昌
东京市区去机场大巴	东京机场大巴
长汀县橘子酒店	橘子酒店长汀
如家快捷酒店南京江苏路店	如家快捷酒店南京路
汉庭东四	汉庭酒店东四
珠海横琴步行街酒店	珠海横琴附近酒店
四房别墅	三房别墅
织里	织 里
武汉玛雅水上乐园门票团购	玛雅水上乐园武汉
都江堰站到犀浦	犀浦站到都江堰
长岛兴隆渔家	长岛兴隆渔家乐
漓江周边酒店	漓江 周边 酒店
西安欧亚学院附近	西安欧亚学院酒店
三亚旅游报团	三亚报团游
武汉欢乐谷周边酒店	武汉欢乐谷怡尚花园酒店
丽水自驾一日游	丽水一日
广州长隆野生动物世界2大2小	广州长隆野生动物世界两大一小
上海迪士尼周边酒店万怡酒店	上海万怡酒店迪士尼
极地海洋世界黄皮	极地海洋海洋世界
理丽江双人游	双人丽江
嵊泗岛二日游	嵊泗列岛两日游
日本在留	日本在留资格
清远出发惠州跟团跟团游	连州跟团游清远
乌镇西栅区内住宿	乌镇住宿西栅
西双版纳自由行4天	西双版纳自由行4天3晚
三亚亚龙湾短租	三亚 短租
张家界巴黎之星酒店	巴黎之星
傣秀表演西双版纳	西双版纳傣秀剧场
浙江杭州紫云饭店	紫云饭店杭州
泰国普吉岛翼双别墅假日酒店	泰国普吉岛双别墅假日酒店
龙门石窟大门票	龙门石窟门票
沈阳洗浴	沈阳洗浴当地玩乐
亚龙湾国际玫瑰谷	亚龙湾玫瑰谷
全季南京夫子庙	南京全季酒店夫子庙
广州增城嘉华温泉酒店	增城嘉华温泉度假酒店
双月湾酒店	双月湾附近的酒店
长沙至常德	常德到长沙
上海上南路四季	上海驿亭四季酒店三林店
常德机场	常德桃源机场
呼伦贝尔旅游五天4晚	呼伦贝尔旅游四日
成都下东大街	成都 下 东 大街
缅甸电话卡旅游4g境外	缅甸上网电话卡
鹿城区酒店	鹿城区学院中路
江宁温泉酒店	江宁温泉
玻璃桥张家界	张家界玻璃栈道
境外旅游保险玩乐	旅游境外保险
飞泰国行李托运额	泰国航空托运行李额
马六甲名宿	马六甲民宿
长城嘉峪关	嘉峪关城楼
wife巴厘岛	巴厘岛wife
杭州塘栖枇杷园	杭州塘栖枇杷
大连体育中心皇冠假日酒店	大连皇冠假日
Y Yegin	Y yegin
虎门高铁站火车票	虎门高铁站
钱江世纪城	钱江世纪城地铁站
开元森泊度假雨林餐厅	开元森泊度假乐园雨林餐厅
黄山旅游风景区南门	黄山旅游风景区
万豪国际旗舰店	万豪旗舰
那拉提风景区	那拉提景区门票
香港华丽海景酒店铜锣湾	香港华丽铜锣湾酒店
恩平五国温泉小镇	恩平温泉乐园
宁波浙江大学软件学院酒店	浙大宁波理工学院
惠州巽寮湾浪琴海公园度假酒店	惠州巽寮湾海公园度假日酒店
佛岗冰川谷	佛冈冰川谷
瑞士跟团游深度	瑞士跟团游
任游 罗蒙湖	罗蒙湖
长沙小团	长沙当地跟团游
中山城市便捷酒店	中山城市便捷
安庆的精选酒店	安庆酒店
惠州双月湾别墅轰趴	广东惠州双月湾别墅
深圳米尔顿精品	深圳米尔顿酒店
颐德酒店	颐德
芙蓉芳	芙蓉王
广州飞揭阳	广州到揭阳
火车旅游专列新疆	新疆火车旅游专列软卧
惠州中海汤泉度假村	惠州中海汤泉温泉度假酒店
羊狮慕明月山套票	羊狮慕明月山
境外旅游意外保险出境旅行险	旅游意外保险
都江堰酒店套房	都江堰酒店
穿心鼓楼站	穿心鼓楼地铁站
顺德公寓酒店	顺德新城区
全季酒店杭州江陵	全季酒店杭州滨江店
百里荒景区小吃	百里荒景区
yangquan	阳泉
上海市虹口区北苏州路	上海市虹口区东体育会路
湛江南	湛江住宿
浏阳维也纳酒店	浏阳维也纳
桂林到阳朔轮船	桂林到阳朔游轮
稻城亚丁7天	稻城亚丁5天
库车租车自驾	库车 租车
平顶山二中	平顶山第二中学
黄山汤口风景区	汤口住宿
百合公寓	百合酒店公寓
深圳趣旅旅游专营店	深圳趣游玩旅游专营店
上海迪士尼维也纳国际酒店	上海迪斯尼乐园附近酒店维也纳
华侨城南戴河滨海国际旅游度假	华侨城滨海国际旅游度假区
韶关仁化县	韶关仁化
迪士尼官方店	迪士尼旗舰店
南靖县酒店	南靖县
丽水云和云曼民宿客栈	丽水云和云漫民宿客栈
三水森林公园门票	三水森林公园
深圳东海岸	深圳前海湾
普吉沙发里骑大象普吉老镇	普吉沙发里骑大象
邵武宾馆	邵武体育宾馆
天御开元酒店	天域开元酒店
无锡江南大学东门酒店	无锡江南大学
弘阳未来世界学生	弘阳未来世界
蹦床公园青岛	青岛蹦床乐园
石家庄新百广场华强广场酒店	石家庄新百广场酒店
兰考到常州	常州到兰考
白沙湾海上乐园海景小木屋	白沙湾海滨公园
斯米兰大船	斯米兰船
龙虎山二日自驾游	龙虎山二日
梧州青旅	梧州青年旅馆
铜梁玄天湖	重庆市铜梁玄天湖
洱海环海游	洱海环游路线
京城大酒店	京城酒店
旅行社 	旅行社
成都太古里晶融汇公寓	成都晶融汇公寓酒店
马来西亚 机票	机票马来西亚
城市客栈北京欢乐谷店深圳	城市客栈深圳欢乐谷店
阳江海陵岛酒店套房	阳江市阳江海陵岛酒店
蒲田湄州岛	莆田湄洲岛
舟山嵊泗等风来	舟山嵊泗列岛民宿等风来
珠海御泉	珠海御温泉
包车玉龙雪山	玉龙雪山包车
杭州市如家精选酒店	杭州市如家
惠州名宿	惠州 民宿
维也纳酒店深圳坂田五和我的酒店	维也纳酒店深圳坂田五和
端午节三日游北京出发	三天两晚北京出发
麻城龟山韩	麻城龟山
长隆野生动物园团体票	长隆野生动物园票
北京格林豪国展店	格林豪泰北京国展店
华山温泉酒店	华山温泉
弘阳未来世界	弘阳未来世界门票
三亚湾短租房可做饭三室	三亚湾名宿租房可做饭4室
包车庐山	庐山包车自由行
cc智臻酒店	Cc智臻
北京诺夫特和平	北京诺富特和平宾馆
杭州市汽车旅馆	汽车旅馆杭州
青岛滨海学院附近的酒店	青岛滨海学院
武汉到兰考	兰考到武汉
乐清到杭州东的火车票	杭州东到乐清的火车票
尚尔酒店	尚尔
厦门美仑皓辉	厦门美仑皓晖
上大路99	上大路地铁站
重庆蜂巢	重庆蜂巢酒店
南京鼓楼医院边的酒店	南京酒店鼓楼医院
莱华酒店	莱华
济源市职业技术学校	济源市职业技术学院
万达广场(济宁太白路店)	济宁万达广场
广州从化温泉套票	广州从化温泉2天
秦皇岛北戴河海边酒店	秦皇岛北戴河海景房酒店
韩国4g卡北京	韩国电话卡
重庆南山一颗树夜景游	重庆南山一棵树观景台门票
乌镇西栅民宿13	乌镇西栅民宿
微信乐游卡欧洲	欧洲乐游卡
滨州希尔顿欢朋	滨州希尔顿欢朋酒店
陕西科技大学西安校区	西安陕西科技大学酒店
上海乐高探索中的	上海乐高探索乐园
横滨出发富士山一日游	日本富士山一日横滨
三里堂	三 里 堂
西安五路口 地铁站 汉庭酒店	西安汉庭酒店科技二路
东方影都皇冠	东方影都皇冠假日
嘉定凯悦酒店hyatt	嘉定凱悅
上海外滩茂悦大酒店代订	上海外滩茂悦大酒店
重庆高铁票	重庆高铁
维也纳国际酒店(苏州高铁北站相城黄埭店)	苏州维也纳酒店
嵊泗列岛三天两晚	嵊泗三日游
上海迪士尼乐园门票双人票	上海迪士尼乐园门票二日票
西湖大道酒店	西湖大道149
陕西中青旅新加坡签证	中青旅签证新加坡
海岛舟山	舟山海岛两日
新加坡机场滑滑梯	新加坡机场
南京中國女人街	南京 中国 女人街
中山路附近的酒店	中山路附近酒店
张掖洗浴中心	张掖洗浴
杭师大附近的酒店	杭师大仓前校区酒店
芜湖如家商旅酒店	芜湖如家酒店
荆州方特东方神画攻略	荆州方特东方神画门票双人
一期一会青旅	一期一会青年旅舍
婺源李坑茶香客楼	婺源 李坑 茶 香客 楼
牙庄 	芽庄
艺术馆	艺术博物馆
广东佛山三水温泉度假村	佛山市三水温泉
承德如家快捷酒店火车站店	如家承德火车站店
普吉西蒙人妖表演秀懒猫	西蒙人妖表演秀普吉
千户和小七孔	小七孔千户
余姚南站	余姚站
大连温泉汤本汤	大连温泉俭汤
潍坊金马大酒店	潍坊天马大酒店
苏梅岛班塔来度假村	苏梅岛班塔蕾度假村
广州飞泰国	曼谷飞广州
春秋寨景区	春秋寨索道
常州丽豪	常州丽豪假日
云顶山庄酒店	云顶山庄
滑雪天水	滑雪场天水
义乌到许昌	许昌到义乌
张家港金凤凰温泉度假村	张家港金凤凰温泉门票
苏州到萧县	萧县到苏州
上海出发烟台自由行	烟台自由行
紫荆广场	紫荆广场附近酒店
康辉旅行泰国签证	康辉泰国签证
滑雪场南山	南山滑雪场门票
东京公交卡	东京交通
普陀山二日游跟团游	普陀山二日游跟团
上海会展中心附近酒店	上海国家会展中心酒店
河北雄安新区	河北雄安
丽江攻略游	丽江市区旅游
天津 自助	自助餐天津
茂名浪漫海岸温德姆酒店房车	茂名浪漫海岸温德姆酒店门票
如家杭州	如家酒店杭州
桂林猫儿山云峰阁度假山庄早餐券	桂林猫儿山云峰阁度假山庄早餐
大阪环球影城门票1145	大阪环球影城1.5门票
树屋成都	成都周边树屋
怡莱精选酒店	怡莱精品酒店
临汾的如家酒店	临汾如家
初见名宿重庆	初见民宿重庆
温州1日游	温州一日游跟团
江油站	江油火车站附近的酒店
上海迪士尼 民宿	上海迪士尼度假区民宿
罗田天堂寨跟团游	罗田天堂寨
星河湾汤泉	星河湾汤
杭州西湖附近花店	沐西墅酒店公寓杭州西湖音乐喷泉店
林州石板岩住宿	林州石板岩
大连工业大学附近的酒店	大连外国语大学附近酒店
石家庄的旅馆	石家庄住宿
长隆野生动物园自助餐	长隆野生动物园餐厅
上海虹桥嘉廷酒店	上海嘉廷酒店
lencois济州岛	济州岛leo
重庆 船票	重庆轮船票
奥兰多迪士尼乐园酒店	奥兰多迪士尼酒店
大理留宿一晚客栈	大理古城周边客栈
抚仙湖门票	抚仙湖景点
湛江万达广场维也纳国际酒店	湛江市维也纳国际酒店
雅斯特武汉庙山	雅斯特国际酒店(武汉庙山武昌理工学院店)
济南第二十六中学	济南第九中学
北京格林豪泰酒店光明	北京格林豪泰酒店光
港澳珠大桥一日游珠海夜游	珠海一日游港珠澳大桥
舟山沈家门半升洞码头	舟山沈家门半升洞码头住宿
洗浴住宿武汉	洗浴中心武汉
乌镇千颂酒店	乌镇千颂
滑雪江浙沪	江浙沪滑雪场
上海虹桥机场睡机场	上海虹桥机场
深圳喜来登	深圳大中华喜来登酒店
昭通民族中学附近的酒店	昭通实验中学
天津泰达航母主题公园五大道	天津泰达航母主题公园
南京水魔方团	南京水魔方
皇冠海景	皇冠海景酒店
哈尔滨苹果假日酒店	哈尔滨苹果假日酒店（海城简约风情店）
淄博银座佳驿酒店	银座佳驿淄博共青团路店
潮汕站到广州南站	潮汕站到广州
青海湖塔尔寺一日游包车	青海湖一日游包车两人
北京鸟巢水立方门票鸟巢	鸟巢水立方夜景
青雅	青雅酒店
哈尔滨美豪丽丽	哈尔滨美豪
长沙南到贵阳	长沙到贵阳
海南三亚高端游济南出发	从济南出发跟团游三亚亲子游
大连特价机票	北京到大连机票
广州到文山	文山至广州
南京到淄博	淄博到南京
呼和浩特 上海	呼和浩特上海
惠州巽寮湾民宿别墅	惠州巽寮湾沙滩名宿
迪斯尼万豪	万豪迪斯尼
深圳皇家维也纳酒店	深圳维也纳酒店
长隆野生动物世界家庭季卡	长隆野生动物世界家庭门票
丽水市职业高级中学	丽水市中心医院附近酒店
张家口张北县宾馆	张家口张北县酒店
贵州旅游五天	贵州旅游5天
青城山 后山	青城山古镇
汕尾城区	汕尾二马路附近的酒店
杭州本地团	杭州当地团
扬州早茶酒店	扬州早茶 
巢湖汤山温泉	巢湖汤山
邮轮官方旗舰店	邮轮旗舰店
京都祗园艺妓表演	京都艺妓表演
杭州金铂湾酒店	杭州金铂湾
重庆解放碑附近的亚朵酒店	重庆的亚朵酒店
舟山普陀区雷迪森酒店	舟山雷迪森假日
大阪环球影城的门票送wifi	大阪环球影城门票 wifi
oyo武汉新鸿运宾馆	武汉新鸿运宾馆大智路
移动wife	wifi移动
骑行川藏线	318川藏线骑行
逸宿酒店宁海	宁海逸宿
黔东南苗族侗族自治州西江千户苗寨景区	黔东南苗族侗族自治州西江千户苗寨景区-观景台酒店
上海迪士尼附近民宿	上海迪士尼度假区附近民宿
新加坡国立大学	新加坡南洋理工大学附近酒店
微爱主题酒店重庆江北九街	重庆微爱酒店江北店
三亚海棠湾天	三亚天
连城冠豸山石门湖门票	连城冠豸山石门湖一日
广州长隆欢乐世界丽枫酒店	广州长隆丽枫
虎门站到广州	虎门到广州南站
无锡 凯莱大酒店	无锡凯莱酒店
广州万豪国际集团酒店	广州万豪酒店
广州广东工业大学大学城校区	广州大学大学城校区
长白山天池北坡门票	长白山天池
深圳瀑布	深圳演出
江门温泉套餐	江门温泉度假村
深圳华侨城天机	深圳华侨城
苏州市苏州山塘街酒店	苏州塘山街
如家上海路地铁	如家上海地铁
黄山汤泉	黄山 温泉
西安钟鼓楼区附近酒店如家酒店	西安如家精选酒店南大街8号
银川有什么好玩的	银川周边有什么好玩的
巢湖深夜温泉	温泉巢湖
三亚亚特兰蒂斯三天两晚	三亚亚特兰蒂斯酒店3天2晚
成都青旅酒店	成都 青旅
延安市内一日游	延安一日游纯玩
耒阳西站	耒阳站
南戴河海边民宿	秦皇岛南戴河海边民宿
宜佳精品酒店	宜佳快捷酒店
宜尚酒店（武昌火车站广场店）	宜尚酒店武昌火车站
敦煌5日游	敦煌五日游
一居一舍	一居E舍
诺唯真游轮·喜悦号	游轮诺唯真
南通到贵阳	贵阳至南通
大连市酒店	大连 市 酒店
云南东辰国旅昆明专营店	云南佳程国旅专营店
易融	易融酒店
广州长隆年卡	广州长隆 年卡
客运中心站	客运中心附近酒店
武汉主题酒店亲子	主题酒店武汉主题酒店
玉溪蓝天里酒店	玉溪蓝天里花园酒店
新加坡水上探险乐园	水上乐园 新加坡
杭州富春开元芳草地乡村酒店	杭州开元富春芳草地乡村酒店
重庆出发恩施大峡谷一日游	恩施大峡谷一日游
厦门购物	厦门 购物
大理市双廊酒店	大理市大理双廊酒店
潜水 普吉岛	普吉岛潜水
上海长途客运南站	上海长途客运北站
毕棚沟成都	成都毕棚沟旅游攻略
重庆大学城尖顶坡酒店	重庆尖顶坡轻轨站
深圳长隆酒店	深圳广州长隆酒店
辽宁工贸学校	辽宁城市建设职业技术学院
自由行哈尔滨往返	哈尔滨六日自由行
浙江自由行四天三晚	浙江四天三晚
跳伞悉尼	悉尼 跳伞
新乡芸栖丽景	新乡芸栖丽景酒店
北京大兴机场休息	大兴机场休息
大理悦庭楠舍精品客栈（古城洱海门店）	大理悦庭楠舍
青岛旅游3日游	青岛3日游跟团
汉庭北京站店	汉庭北京南站北广场酒店
凯旋龙连锁酒店长沙火车站店	凯旋龙连锁酒店长沙汽车西站店
上海中冶翔腾	上海中冶祥腾
杭州到西塘	杭州到西塘古镇
海口钓鱼	海口 海钓
如家快捷酒店（北京昌平路鼓楼西街店）	如家北京昌平鼓楼西街店
廣州南	广州南地铁站酒店
美国古巴墨西哥wifi	wifi 美国 墨西哥
甘孜藏族自治州亚丁村酒店	甘孜州稻城县亚丁村酒店
泰国签证江西免照片	泰国签证免照片
二道白河镇温泉	二道白河温泉
麻城燕加隆福朋喜来登酒店	麻城燕加隆福朋喜来登
那霸机场 巴士	机场巴士
西安钟楼晨小溪寓酒店	西安钟楼晨小溪公寓酒店
希尔顿东莞	东莞希尔顿
扬州文昌阁	扬州文昌阁酒店
亚特兰蒂斯c	亚特兰蒂斯 C
黄山风景区客栈	黄山客栈
重庆一日游 纯玩	重庆 一日游
咸宁崇阳三特浪口森林温泉门票	咸宁崇阳三特浪口森林温泉一日
宜昌机场路宾馆	宜昌机场宾馆
湛江市鼎龙湾	湛江鼎龙湾海洋主题公寓
海口三亚租车电动	海口三亚租车
天津恐龙广场	天津恐龙
茂名旅游景区	茂名旅游景点
境外移动流量包	港澳境外移动流量包
北海银滩观海酒店	北海银滩海边度假酒店
诸暨剧院	诸暨大剧院
杭州开元度假村	杭州开元度假村酒店
沧州市第八中学	沧州市第五中学附近的酒店
西双版纳维也纳酒店	西双版纳维也纳3好酒店
尼勒克的酒店	尼勒克酒店
济南民宿短租	民宿短租济南
慈溪杭州湾海底温泉门票	宁波慈溪杭州湾海底温泉酒店
乌鲁木齐高铁站附近酒店	乌鲁木齐南站
广州机场大巴线路	广州机场大巴
南宁假日	南宁假日酒店
江津客运站	江津中心医院
景江国际酒店	景江大酒店
咸阳西藏民族大学附属中学	咸阳陕西财经职业技术学院酒店
北京水立方嬉水乐园双人票	北京水立方水上乐园
潮汕到深圳北的火车票	潮汕站到深圳北火车票
攀枝花学府酒店	攀枝花学院酒店
满洲里出发去俄罗斯贝加尔湖跟团游	满洲里贝加尔湖跟团游
羊卓雍措 纳木错	羊卓雍错
广东酒店	广东 酒店
秦皇岛7天酒店	秦皇岛七天连锁店
湖南郴州莽山森林温泉酒店	郴州莽山森林温泉酒店
南京民宿新街口	南京新街口附近的酒店民宿
千岛湖钓鱼岛船票	千岛湖钓鱼岛
马来西亚飞猪专线	飞猪专线马来西亚
维也纳酒店 	维也纳酒店
南京奥体博览中心美居酒店	南京南站美居
曲靖北到贵阳北	贵阳站至曲靖
浙商大酒店兴义	兴义帝都大酒店
爬山佛山	佛山 爬山
龙湖度假村	龙湖度假
杭州酒店上城区	杭州上城区
香港哪里酒店最便宜	香港酒店便宜
海棠湾水底世界	海棠湾水世界
福州动车南站附近酒店	福州北站火车站附近的酒店
美娜多白沙岛一日游	美娜多白沙岛
厦门的酒店带泳池	厦门酒店泳池
揭阳炮台镇酒店	揭阳炮台酒店
万豪酒店海口	海口的万豪酒店
锦龙国际酒店	锦龙酒店
杭州到北京的高铁票	杭州到北京高铁
泊隐一念之间	泊隐 一念间
成都￣厦门	成都到厦门
长春往返长白山	长春到长白山
北海到涠洲	北海到涠洲岛
蜜柚旅行接机墨尔本	蜜柚旅行墨尔本
云浮市婵泉度假村	云浮度假村
榆林汽车站	榆林火车站
平谷玻璃台	平谷旅游景点
济南银座佳驿精致酒店	济南银座佳驿
湛江游攻略	湛江市旅游
岷江豪庭	岷江豪庭国际大酒店
西礁山风景	西樵山风景
信阳火车站附近宾馆	信阳火车站
黄山观光缆车	黄山缆车
厦门植物园附近的酒店 民宿	厦门园博苑附近的民宿
深圳会展中心莫泰酒店	深圳南山地铁站酒店莫泰
清远聚龙湾别墅	清远聚龙湾天然温泉度假村酒店
诗巴丹 潜水	诗巴丹深潜
cd创意园公寓天河客运站	cd创意公寓天河客运站
江南客运站	江南 客运 站
乌镇南栅客栈	乌镇客栈
四川省内跟团游	四川旅游
西安热门景点	西安热门一日
从珠海出发到澳门一日游	澳门一日游
茂名壹加壹购物广场附近的酒店	茂名高铁站酒店
香干迪士尼	香港迪士尼
亚龙湾瑞吉	亚龙湾瑞吉酒店
厦门海景壹号客栈	厦门海景1号客栈
山庄旅舍	山庄旅社
香港 韩国流量包 电信	香港电信流量包
大财门酒店	大财门公寓酒店
厦门的公寓	厦门酒店式公寓
南宁城市便捷酒店东葛路	南宁城市便捷酒店枫林路
广州长隆野生动物世界餐	广州长隆野生动物世界早餐
南昌力高皇冠酒店豪华江景房	南昌力高皇冠假日酒店
厦门鼓浪屿海底世界门票鼓浪屿景点	厦门鼓浪屿海底世界门票
南宁朝阳广场附近的酒店如家	如家南宁东站
菏泽全季	菏泽全季酒店
郑州到重庆高铁	郑州至重庆
阳朔两日游纯玩跟团游	阳朔两日
清远古龙峡玻璃大峡谷门票	清远古龙峡瀑布
机场停车乌鲁木齐	乌鲁木齐机场停车
岳阳第七中学	岳阳第十四中
宁夏旅游景点	宁夏一日游纯玩
西双版纳悦椿温泉门票	西双版纳悦椿温泉村
无锡到浦东机场	无锡到浦东机场大巴
浏阳烟花	浏阳烟火大会
湖北香港通行证签注G签	香港通行证签注g签
应城汤池温泉度假村酒店	应城汤池温泉门票
南充市南部县	四川省南充市南部县酒店
成都出发到若尔盖大草原跟团	成都到若尔盖自由行
北京火车站附近快捷酒店	北京站火车站附近快捷酒店
乌镇一日游纯玩杭州出发	乌镇一日游杭州出发小团纯玩
环球影城大阪门票快速票	大阪环球影城门票快速
佛山OYO酒店	佛山市华盈广场酒店
长沙动物门票	动物园门票长沙
巽寮湾海边酒店	巽寮湾海景酒店
阿图什市的酒店	阿图什市
成都青旅游景点	成都旅游景点
重庆S·island高空江景酒店	重庆s高空江景酒店
城隍庙 酒店 上海	上海城隍庙酒店
亚朵酒店人民北路	亚朵人民北路
广州花都住宿	广州花都的酒店
梧州白云山	梧州白云山景区
森悦	悦森酒店
仙居县仙居风景名胜区酒店	浙江仙居神仙居景区附近酒店
双月湾君庭	双月湾君庭酒店
大研古镇酒店	大研古镇客栈
如家商旅沈塘桥	如家酒店沈塘桥
西双版纳篝火	西双版纳篝火晚会门票
三亚帕尔美纳酒店	三亚帕尔美纳国际度假公寓酒店
澳门旅游塔晚餐	澳门塔餐厅
重庆主城景点	重庆主城区景点
清远树屋温泉	清远树洞温泉
三亚南山文化旅游区	三亚南山观音
成都到浙江的机票	杭州到成都机票
江山的当地玩乐	江山一日
深圳的名宿	深圳名宿
优栈商务酒店公寓	优栈公寓
飞猪旒行	飞猪旅行
普陀山精品团	普陀山旅游团
香港8g电话卡	香港电话卡4g
海洋水族馆上海	上海海洋水族馆
皇庭丽景	皇廷丽景
荷兰申根签证	欧盟申根签证
福建厦门鼓浪屿	厦门鼓浪屿
红礼遇酒店	红璞礼遇酒店
福州酒店火车站	福州火车站的酒店
信阳市信阳职业技术学院酒店	信阳学院附近酒店
昆明附近景点	昆明景区
荆州中心医院	荆州市第一人民医院附近的酒店
烟台万豪自助餐	烟台万豪自助
重庆机场附近宾馆	重庆机场宾馆
黄山市黄山北海宾馆	黄山风景区北海宾馆
杭州假日之星酒店	杭州假日之星
保定尚客优品酒店	保定尚客优酒店
玉龙湾滑雪票	玉龙湾滑雪
雨筑亲吻泸沽湖	雨筑亲吻泸沽湖客栈
格林·噜咔奇幻动物王国	格林噜咔奇幻动物王国
深圳世界之窗木	深圳世界之窗
深圳大眉沙	深圳大梅沙
水袜	q家旅行 旅游用品  短款潜水袜
杭州接机送机服务	接机服务杭州
南山竹海茗香别院	南山竹海住宿
成都牛王庙地铁站口酒店	成都2号线牛王庙附近的酒店
通化拉图摩根	通化中东拉图摩根酒店
佛山三水新动力广场	佛山三水万达商圈酒店
扬州 漫心	扬州漫心
芙蓉寺	芙蓉 寺
lycamobile电话卡	lycamobile充值
动物园 福州	福州动物园门票
马尔代夫蜜月	马尔代夫自由行一价全包
厦门鼓浪屿票嵩	厦门鼓浪屿票
和逸酒店	和逸
丰泽菀大酒店	丰泽大酒店
西安乐华城88	乐华城西安
桔橙	桔橙连锁酒店
联通 流量包香港	流量联通香港
深圳户外烧烤	深圳露营烧烤
宁波宝龙广场	宁波宝龙广场(建设中)
成都温泉水疗	成都温泉
凤凰古城滑雪	凤凰城滑雪
阳江摩托艇	阳江大角湾水上摩托
佩尼达岛一日游vip	佩尼达岛一日
广州一娄底	娄底广州
泸沽湖亲爱的客栈房价	亲爱客栈泸沽湖
郑州飞三亚机票	三亚 郑州往返机票特价
上海迪士尼跟团游邯郸出发	上海迪士尼跟团游上海
杭州迎江宾馆	杭州银江宾馆
万安山野生	万安山野生动物
上海佘山世茂洲际酒店 自助	上海佘山世茂洲际酒店
全季松江体育中心	全季松江
九江旅游	九江旅游攻略
南山 滑雪场	北京滑雪一日游
皇龙大峡谷门票	皇龙大峡谷
漳州万达附近的酒店	漳州市区酒店
仙女山大卫	仙女山 大卫
佛山 万达	佛山万达广场
川西领队	川西小环线司机
曼谷 去 芭提雅	芭提雅去曼谷
绍兴柯桥开元颐居	开元颐居绍兴
曼谷市区王权免税店接送	曼谷王权免税店接送
白玉兰酒店襄阳	白玉兰襄阳
合肥如家派柏云	如家睿柏云酒店合肥火车站
泊尔家	泊尔家城市艺术
周庄古镇酒店	周庄古镇住宿
宁波科技博物馆	博物馆宁波
张家港美伦精品酒店	张家港美伦
新疆 深度	新疆纯玩
武汉保利茉莉公馆主题	武汉保利茉莉公馆
西双版纳火车	西双版纳火车票
公交卡江苏	江苏公交一卡通
西安康博尔	西安康博尔艺术
黄山 白云宾馆	白云宾馆黄山
郴州雾漫小东江酒店4星	郴州雾漫小东江酒店
宁波小别墅	宁波别墅
上海迪士尼2日门票酒店	上海迪士尼门票2日联票加酒店一大一小
成都四川省妇幼保健院	成都四川省骨科医院酒店
南长街步行街	南长街住宿
台中日月潭九族	台中日月潭
六安的酒店	六安 酒店
麗枫酒店·崇州万达广场店	丽枫酒店崇州
杭州钱江新城市民中心附近酒店	杭州钱江国际时代广场酒店
三日两晚	三天二晚
广州去珠海拱北口岸	广州至珠海拱北直通车
西北大环线8	西北大环线攻略
普吉岛泰式按摩	普吉岛泰式
青岛小团	青岛本地团
张北草原两日游攻略	张北草原二日团游
上海明天广场万豪行政公寓	上海万豪行政公寓
釜山山庄酒店	釜山柏悦酒店
江锦	江锦酒店
布尔津音之帮	布尔津音之邦
绍兴大禹开元度假村	绍兴大禹开元观堂套餐
杭州千岛湖名宿	杭州千岛湖民宿
中山汉普敦	中山南朗汉普敦
杭州中山医院	杭州市第三人民医院
张家口住宿	张家口四中站附近的酒店
西湖古镇	西湖景区
长沙好客来	长沙好客来酒店公寓
北京戒台寺	戒台寺北京
苏梅岛sala酒店下午茶	苏梅岛酒店下午茶
千岛湖市区酒店	千岛湖广场附近酒店
南昌晨悦商务宾馆	南昌鑫悦宾馆
附近火锅店	附近自助火锅店
绵阳江油市	绵阳江油站酒店
深圳海边别墅	深圳团建别墅
陵水海南香水湾书香海景酒店	陵水香水湾书香海景酒店
栾川温泉	栾川汤泉
济南金象山滑雪场门票	济南金象山滑雪
西臧自由行	西臧2日游
十来画廊	十里画廊
烟台南山学院附近的宾馆	烟台南山学院
明月千古情门票	明月千古情一日
铜仁树蛙部落	铜仁树蛙
郑州好如家酒店顺河路	郑州好如家酒店
阳江海陵岛闸坡大角湾海景房	阳江海陵岛大角湾
珠海庙湾岛自由行台山	珠海庙湾岛自由行
川西线自驾游组团	川西自驾跟团
香洲旅游度假区	香洲水上乐园
青岛城阳区附近的酒店	青岛城阳区正阳路酒店
南昌孺子路	南昌儒子路酒店
宜昌情趣酒店	宜昌情侣情趣酒店
大理机酒	大理机加酒
芭提雅一日游猴岛	芭提雅海岛一日
广州加珠海长隆	珠海广州长隆
香港 包车一日游	香港地陪导游
安徽池州仙寓山	池州仙寓山风景区
珠海香洲区人民东路酒店	珠海香洲区附近的酒店
广东英德宝墩湖湖山温泉度假村	英德宝墩湖湖山温泉度假村 
金宝酒店	金宝
肖坝	肖坝酒店
民宿landing	landing民宿
缙云仙都风景区	缙云仙都景区门票
秦岭附近民宿	秦岭民宿
荆州市文星中学	荆州市楚都中学
黄冈当地玩乐	黄冈周边
禧悦丽尊	禧悦丽尊酒店
天津飞重庆	天津重庆
银滩一号	银滩 一号
清远市美林湖温泉度假酒店	美林湖温泉大酒店清远
日本 wifi蛋	日本wi-fi蛋
酒店礼券	酒店五折券
迪士尼烟花秀	迪士尼烟花vip
旅游巴士上海	上海观光旅游
南京市雨花台区宁双路	南京雨花台区软件大道
企鹅餐厅 早	企鹅餐厅
迎宾阁	迎宾阁酒店
郑州到龙岩	龙岩到郑州
广东春节过年旅游	春节过年广东
青岛北站到胶州	青岛西站到胶州
汉江国际会员	襄阳汉江国际大酒店
东莞好玩的地方	东莞附近旅游景点
香港 迪士尼	迪士尼门票香港
兰州黄河船票	兰州黄河游船
清水湾慢到海景度假酒店	陵水清水湾曼岛海景度假酒店
玉林周边温泉	玉林汤泉
福州如家精选	福州的如家酒店
巽寮湾金海湾嘉华酒店	巽寮湾惠东金海湾嘉华
西江千户苗寨到凯里	凯里到西江苗寨
长恨歌加兵马俑	兵马俑长恨歌
首义园美食街	首义园自助午餐街
薄荷岛陆地一日游	薄荷岛陆地游
陕西西安秦岭野生动物园	西安秦岭野生动物园的门票套票
奥特莱斯 普吉岛	懒猫旅行 泰国普吉岛接机送机普吉接送机 机场接机服务旅游泰国
龙门希尔顿温泉门票	龙门富力希尔顿温泉度假酒店
大连市中山区实验学校	大连市中山区春德小学
机上升舱	飞机升舱
喀什维也纳智好酒店	喀什维也纳
保定桃源快捷酒店	保定桃源酒店
长沙湘西凤凰古城的酒店	湘西凤凰古城酒店
长沙的博物馆	长沙湖南省博物馆
钱冲县古银杏	钱冲银杏谷
西西友谊饭店	北京西西友谊酒店
曼德勒一日	曼德勒
三门旅游	三门一日游
伟华大酒店	伟华
台州滨海工业区酒店	台州海上客运中心
沂源县的酒店	沂源
丽江 租车	丽江租车服务
荆门高空跳伞	跳伞荆门国内
番禺香江	番禺香江大酒店套票
玛雅水上乐园门票南京	南京玛雅水上乐园门票
世纪游轮官网	世纪游轮
千岛湖洲际酒店专营店	千岛湖洲际
香港太平山顶缆车免排队实体	香港太平山顶缆车免排队当日
东莞租车自驾	东莞租车
端午节三亚	端午 三亚
韩尚品瑞	韩尚品瑞酒店
安宁市职教园区麒麟路	安宁职教园区
208世界杯	世界杯2018
维也纳酒店杭州春	杭州维也纳酒店
石家庄市第一中学	石家庄市第二十一中学
三亚索菲特直升飞机	三亚索菲特 直升机
曼谷  按摩	曼谷sap
武功县	武功县的酒店
厦门一席墨	厦门一席
北京7天优选	北京7天
西溪森林温泉度假	西溪温泉森林酒店
西安蓝溪国际大厦酒店	西安蓝溪国际大厦
敦煌火车站	敦煌站
日本双人游	日本团体游
弋阳酒店	弋阳的酒店
横滨港未来通票	横滨港未来
杭州市西溪医院附近的酒店	杭州市第一人民医院附近的酒店
船票济洲岛	济州岛票
悉尼去堪培拉	悉尼堪培拉一日游
流水山舍	流水山舍民宿
成都九寨沟黄龙	成都黄龙九寨沟
星乐度横琴露营乐园门票	横琴星乐度露营小镇
济南十六里河中学酒店	济南舜耕中学酒店
绵阳至成都飞机	绵阳到杭州飞机
类乌齐县	类乌齐县的酒店
t眯一会	眯一会
企鹅酒店2天1夜海洋王国套票	企鹅酒店2天1夜海洋王国套票晚餐
长治租车	山西长治租车
曼途名宿安吉	安吉曼途名宿
松江希尔顿	上海松江希尔顿
泉州周边游	泉州二日
陇鑫	陇鑫国际
三亚跟团游深圳出发	深圳跟团游三亚
内乡宝天曼	内乡宝天曼门票
郑州龙湖商业广场酒店	郑州双湖大道附近的酒店
古北水镇精品酒店	古北水镇 酒店
即下山重庆	即下山 重庆
塞班跟团游武汉	武汉塞班
太湖龙之梦动物园酒店	太湖龙之梦动物世界酒店
日本五年多次签证	五年签日本
南京3日游	南京半自由行
东莞市樟木头三正半山酒店	东莞三正半山酒店（樟木头观音山店）
武汉天马城市旅馆	武汉天马城市旅馆大成路店
日本3年多次签证	日本3年
上海市第一妇婴保健院	上海市第一妇婴保健院东院酒店
森泽苑	森泽苑酒店
长春包车去长白山	长白山包车长春
稻城亚丁4天3晚自由行	稻城 亚丁 4 天 3 晚 自由 行
宽窄巷子功略	宽窄巷子攻略
武汉到济南的高铁	武汉到济南
西安的酒店希尔顿	西安希尔顿欢朋酒店
玉渊潭冰场	玉渊潭公园冰场
香港迪士尼游乐园酒店	香港迪士尼乐园酒店
杭州泛海钓鱼台自助餐	杭州泛海钓鱼台酒店 双人特惠下午茶
广州南到潮汕站	广州东到潮汕站
阳江涛景高尔夫度假村	阳江度假村
河南省实验中学	河南省工业学校附近的酒店
浙江大学附属中学玉泉	浙江大学玉泉
大兴大厦尚客优快捷酒店兴化大兴店	尚客优快捷酒店兴化大兴店
重庆丽枫酒店观音桥	重庆丽枫
摩天轮 新加坡 晚餐	新加坡滨海湾摩天轮
泰国 一年多次	泰国三年多次
重庆定制游	重庆报团游
黄岛涵碧楼酒店	黄岛涵碧楼
深圳高新园	深圳高新园地铁站附近的酒店
乐汤汇温泉生活馆 天津店	天津乐汤汇
昆明嵩明酒店	昆明嵩明县
迪斯尼票	迪斯尼门票VIP
珠海长隆二日游	珠海长隆二日
北京三环快捷饭店	北京快捷酒店三环
长沙湖南国际会展中心酒店	长沙国际会展中心附近酒店
珠海一日游港珠澳大桥	粤港澳大桥一日游珠海
兰桂坊酒店	蘭桂坊
右见酒店	右见
青海甘青小环	青海315国道
禾木到乌鲁木齐	乌鲁木齐到禾木
荆州市荆州区南环路长江大学	荆州湖北长江大学附近的酒店
古巴跟团	古巴自由行
三亚到武汉的机票	武汉飞三亚往返的机票
香港迪士尼酒店+套票	香港迪士尼酒店套票
珠海横琴创新方酒店	珠海横琴创新方
庐山大厦民国	庐山大厦民国主题文化酒店
金明国际酒店	金明大酒店
玉龙雪山当日索道门票	玉龙雪山门票大索道
三亚海棠湾jw	三亚 jw
桂林阳朔电动车出租	阳朔租电动车
唐山山叶口通票	唐山山叶口套票
马来西亚加新加坡签证	新加坡签证马来西亚
东莞 温泉	东莞温泉
郑州火车站 地铁站	郑州火车站地铁口 酒店
甲壳虫三亚租车	三亚甲壳虫
上海佘山世茂深坑酒店水下餐厅	上海佘山世茂深坑酒店
北京西单附近酒店	北京西单地铁站附近酒店
泰国活力探戈生活酒店	泰国活力探戈生活馆酒店
温州瓯海区六虹桥路	温州市瓯海区瓯海大道2555号
城市之家酒店(合肥浙商城店)	城市之家酒店（合肥火车站店）
姬拉度假	姬拉度假酒店
深圳较场尾海边度假民宿	深圳较场尾民宿海景房
西安电动车租赁	西安租电动车
迪拜旅游	迪拜游
淄博蓝海国际大饭店	淄博蓝海酒店
马尔代夫阿雅达度假村	马尔代夫阿雅达岛
重庆做船游	重庆。船
香港水晶旅馆酒店	香港水晶酒店
成都简驻太空舱青年旅舍	成都太空舱青年旅舍
张家界3日游纯玩	张家界三日游纯玩跟团游
张家界景区内住宿	张家界森林公园内客栈
台湾  wifi	wifi台湾
对天河漂流两日	对天河漂流一日
上海布丁酒店地铁附近	上海布丁酒店地铁
宜昌旅行社	宜昌跟团
北京亲子游自由行攻略	北京自由行攻略
眉山火车站	眉山站
上海浦东新区陆家嘴附近的酒店	上海浦东陆家嘴附近的酒店
上海欢乐谷玛雅	上海欢乐谷玛雅海滩水公园门票
江油青龙峡漂流	四川江油青龙峡漂流门票
苏州不二居	苏州不二居轻奢民宿
玉林财经学校	玉林师范学院东校区附近的酒店
香洲港->外伶仃岛	香洲港外伶仃岛
天津尚客优选	天津尚客优精选
上海欢乐大马戏	上海大马戏
无锡三阳广场附近的民宿	无锡站附近民宿
贵阳人民广场	贵阳中山西路酒店
清迈夜间动物园吃饭	清迈夜间动物园清迈动物园
福建省省立医院附近的酒店	福建省妇幼保健院旁边酒店
金华蒲江	金华浦江
抚仙湖希尔顿酒店附近的酒店	抚仙湖希尔顿酒店
福建信息职业技术学院平潭校区	福州平潭汽车站
灵山和拈花湾	灵山拈花湾
南京中山陵免费预约	南京旅游景点门票中山陵预约
雪乡  伏尔加庄园	伏尔加庄园
行李份额泰国皇雀	亚航行李托运额泰国亚航行李托运酷鸟酷航越捷皇雀航空行李额购买
金华市万达嘉华酒店	金华市万达酒店
加拿大旅游团	加拿大跟团
郑州市第七十六中学	郑州市第九十六中学
广西南宁跟团游	南宁跟团跟团游
澳门手机卡2日	澳门日电话卡
漯河黄河广场酒店	漯河高铁站附近的酒店
保利瑰丽下午茶	保利瑰丽酒店下午茶
山东青岛民宿短租房	山东青岛五四广场附近的民宿
南昌市第三医院	南昌市第三医院附近的酒店
谷兹 青城院子	青城谷兹院子
苏州中学附近酒店	苏州第十中学
迪拜航空	迪拜阿联酋航空商务舱
青岛如家酒店	青岛如家商旅酒店
上海迪士尼门票vip通票	上海迪士尼门票vip通行证
西安到乌鲁木齐	乌鲁木齐市到西安
徐家汇地铁站	徐家汇地铁站附近酒店
烟台长岛优客渔家	烟台长岛海东渔家
黔巅韭菜坪	黔颠韭菜坪酒店
杭州开元泊森度假酒店树屋	杭州开元森泊度假酒店木屋
杭州西湖附近的民宿	杭州西湖附近民宿
普及一日幻多奇	普吉幻多奇接送
南京出发周边游3日游	南京周边三日游
大连迪士尼	大连上海迪士尼
泸沽湖尔湾水奢度假别院	丽江泸沽湖尔湾水奢
从化森波拉	从化 森 波拉
深圳租房子月租	租房子一个月深圳
俄罗斯大庆出发	俄罗斯重庆
南山滑雪场直通车	南山滑雪场 交通
欢乐谷武汉夜场	武汉欢乐谷门票日场
铂特酒店	铂特商务酒店
杭州下满觉陇民宿	杭州上满觉陇民宿
城市便捷肇庆	城市便捷酒店肇庆七星岩风景区
中山南站	中山北站
杨家古北水镇	古北水镇杨家
壶口瀑布黄河一日游	山西黄河壶口瀑布一日游
云昆山森林公园	昆山森林公园
上海迪士尼一家三口	上海迪斯尼全家
杭州到诸暨五泄	诸暨五泄
银川西夏王陵	银川西夏王陵门票
北京citigo三元桥	citigo酒店北京
南京出发舟山	南京出发舟山跟团
吴起	吴起酒店
租 翻译	翻译机租赁
吴淞码头票	吴淞码头
庐山二日游看日出	庐山风景名胜区2日游
拉萨6天	拉萨6天5晚
土耳其 手机卡	土耳其上网卡无限流量
泰国普吉一日	泰国普吉岛浮潜
日本jr通票东京大	日本东京jr通票
全季酒店深圳南油	全季深圳南油地铁站酒店
杭州商圈	杭州湖滨商圈
萧山火车站	萧山火车南站
丽江多弗	丽江多弗酒店
广州 九龙湖	广州九龙湖
拉萨火车站	拉萨站
千岛湖3天2晚家庭游	千岛湖三天两夜自由行
驻马店确山酒店	河南驻马店确山县
厦门的当地酒吧	厦门当地
贵港市职业教育中心	贵港市江南中学
琼海皇家骑士万泉度假酒店琼海	琼海皇家骑士万泉度假酒店
固史	固始
曼谷自駕	曼谷 自驾
全季酒店(杭州滨江江南大道店)	全季酒店杭州滨江店
丰顺的门票	丰顺门票
珠海到深圳鸿隆明华轮酒店保姆车商务车	深圳鸿隆明华轮酒店
成都龙湖时代天街	龙湖成都时代天街
宁波万人沙滩景区	万人沙滩宁波
香港 电话卡	手机卡香港
华北机电学校	华北科技学院附近酒店
福州 鼓山	福州市鼓山风景区
上海到济南火车票	济南到上海高铁
石家庄无极县附近的酒店	石家庄无极酒店
上海迪士尼吃饭看烟花	上海迪士尼烟火的晚餐
重庆民宿loft	loft民宿重庆
深圳领航花园	深圳领航花园商务酒店
Gs	gs
河北对外经贸职业学院	河北旅游职业学院
jrpass东日本3日	东日本 jrpass
香港迪士尼儿童2日票	香港迪士尼门票儿童票
迪士尼酒店套票多种门票	迪士尼门票酒店套票
重庆黑山谷附近的酒店	重庆黑山谷风景区酒店
柏曼酒店 桂林两江四湖店	桂林柏曼
重庆成都自驾游	自驾游成都
优莱客精品酒店	优莱客连锁酒店
中科大附近酒店	中科大附中
悉尼luna park	悉尼Luna park
速8酒店北京前门天坛公园	速8酒店北京前门东大街店
三亚仁恒皇冠酒店	三亚仁恒皇冠假日酒店
迪拜跳伞跟团	迪拜 跳伞
北京南站 酒店	北京南站高铁站附近的酒店
新加坡机场打包	新加坡机场
小汤山私汤	小汤山私汤温泉 三人
华宇温德姆至尊豪廷大酒店	华宇温德姆酒店
婺源北线一日游	婺源一日游
广州长隆欢乐世界圣诞节夜场儿童	广州长隆欢乐世界圣诞夜场票
大阪国际环球影城 快速票	大阪环球影城快速票
日本游船	日本 游船
时光主题公寓天津	天津时光
雪乡旅游团	雪乡旅游跟团
舟山祥生大酒店普陀山	普陀山祥生大酒店
深圳 海洋馆	深圳海洋世界
舟山嵊泗列岛出海	舟山嵊泗列岛船票
汤山温泉洗浴中心	 汤山温泉
北京建筑大学	北京理工大学
解放碑店	解放碑酒店
大阪 租婴儿车	大阪婴儿车出租
如家-上海南京路步行街店	如家商旅-上海南京路步行街店
万信酒店上海国际旅游度假区店	万信酒店上海国际旅游度假区
西安特价机票	西安往返机票
厦门第一中学	厦门第十中学
北海涠洲岛极景美宿	北海涠洲岛海景
上海迪士尼乐园酒店双人门票套餐	上海迪士尼乐园酒店套餐双人
长春周边旅游景点	长春当地玩乐
迪庆 英迪格	英迪格迪庆
阜阳市颍州区	阜阳市颍州中学
月光宝盒度假酒店	月光宝盒度假
上海到桂林旅游团	上海去桂林
云南旅游机票	云南旅游含机票
家美大酒店	家美酒店
悉尼旋转餐厅	悉尼塔旋转餐厅
埃及攻略	埃及当地游
杭州直飞苏梅	杭州苏梅自由行机票
蚌埠工艺美术学校新校区	蚌埠新城实验学校
上海民宿可做饭	上海民宿带厨房
三亚海棠湾9号度假酒店官方	三亚海棠湾9号度假酒店套餐
广州雅诗阁公寓	广州雅诗阁服务公寓
自驾游青海湖	环青海湖自驾
珠海夏湾现代商旅酒店	珠海夏湾
赤峰沈阳	沈阳赤峰
维也纳三好酒店北京	北京维也纳3好酒店
clubbed北京延庆度假村	Club Med Joyview 北京延庆度假村
清远3日2晚广州	清远3日2晚
宁海旅行	宁海旅游
杭州长桥新极地海洋公园	极地海洋公园杭州
广州从化清音	广州从化清音酒店
马尔代夫都喜天丽岛	都喜天丽马尔代夫
广州从化附近的酒店带温泉	广州市从化温泉酒店
南通市海底世界	南通市探险王国
威海到大连的轮渡	大连到威海的船票
长沙t1休息室	长沙南站休息室
宝龙艺珺酒店	宝龙艺珺
三亚帆船出海亲子	三亚 帆船
锦州医科大学附近酒店	锦州妇婴医院附近的酒店
南通森林野生动物园夜场	南通森林野生动物园门票
杭州出发黄山一日游	杭州到黄山一日游
康定新都桥松涧星月	康定松涧星月
秦皇岛燕山大学附近酒店	秦皇岛燕山大学东校区酒店
迪拜手机卡 	迪拜手机卡
长隆野生动物园自驾游车票	长隆野生动物园快捷票
广州如家酒店	广州如家酒店北京路步行街
荔波大小七孔景区	荔波小七孔门票
海口银洲宾馆	海口金洲宾馆
美憬阁索菲特酒店	索菲特美憬阁
扬州诺富特酒店	扬州瘦西湖诺富特酒店
长春高速公路客运站	长春高速客运站
威海荣成	荣成的酒店
延庆 温泉酒店	延庆温泉度假村
乌镇loft	乌镇民宿loft
日本wi fi	日本无限流量
惠游天下旅游网	惠游天下旅行网
南京钟山风景名胜区	钟山风景区南京
太平老街酒店	酒店太平老街
南昌八一馆酒店	南昌八一馆
厦门牡丹国际	厦门牡丹国际大酒店
派酒店 乌鲁木齐机场店	派酒店·乌鲁木齐机场店
西安一深圳的飞机	西安到深圳飞机
三亚亚龙湾亚特兰蒂斯酒店	三亚亚特兰蒂斯酒店海景房
惠东双月湾半岛海景度假公寓	惠东双月湾海景
虞城酒店	虞城的酒店
无锡年票	无锡景点年卡
日本旅游樱花季	日本 旅游 樱花 季
漳州景点	漳州景区
甘孜跟团	甘孜跟团游
福州三日游玩	福州3日游纯玩
自由行 普吉	普吉岛旅行
上海浦东香格里拉大酒店陆家嘴	上海浦东香格里拉大酒店
南昌万达乐园门票	江西南昌万达游乐园
小东海浮潜	小东海 浮潜
广州烈士陵园酒店	广州烈士陵园附近酒店
宝天曼自驾游	宝天曼
长沙湖南森林植物园门票当日	湖南省长沙森林植物园门票
三亚宋城旅游区彩色动物园	宋城彩色动物园三亚
三亚海棠湾自助	三亚海棠湾酒店自助餐
秦皇岛国家发改委培训中心	秦皇岛发改委培训中心
西夏万达情趣	西夏万达情侣
冬天的拉萨	拉萨冬天
境外旅行险婴儿	安盛天平境外旅行险差价【不显示评价销量】
深圳到郑州特价机票	郑州到深圳机票
生命奥秘	生命的奥秘
天津攻略	天津一日游攻略
北戴河 疗养院	北戴河交通部疗养院
成都熙熙里公寓	成都熙熙里套房公寓
西安中建馨乐庭	西安中建馨乐庭高新公寓酒店
城市便捷酒店东莞	城市便捷酒店东莞南城店
周口客运站	周口汽车站
楚河汉界影院	楚河汉界
榆林第七中学	榆林实验小学
临沂蹦床公园	临沂蹦床工厂
大望路	大望路附近酒店
贵阳云岩区酒店	贵阳白云区第七初级中学酒店
山西大同住宿	山西大同火车站附近旅店
深圳休息室	休息室深圳
成都到晋江机票	成都到晋江的机票
语自在民宿	语自在名宿
星星太空舱青年旅社	西安太空舱青年旅社
南京南休息室	南京休息室
泸沽湖那年客栈	泸沽湖那年
方特门票沈阳	沈阳方特门票夜场
酒店南澳岛	南澳岛附近的酒店
泉州湖美大酒店	福建泉州湖美大酒店
洗马潭索道门票	洗马潭大索道
上海共康路(地铁站)酒店	上海市上海共康路地铁站酒店
漳州云霄金汤湾温泉门票	漳州云霄金汤湾海水温泉度假村
南浔古镇书画院民宿	南浔古镇住宿
迪士尼上海国际旅游度假区万怡加迪士尼	【当天可订】上海迪士尼乐园一日门票迪士尼门票上海含攻略z
东川红土地风景区	东川红土地
丽江六十八号客栈	丽江六十八号观景客栈
上海汉庭连锁酒店西藏南路	上海汉庭酒店西藏南路
度美酒店	度美
南昌铂尔曼酒店	南昌铂尔曼
话费充值移动	移动手机充值话费
瑞金附近旅游景点	瑞金市旅游景点
青山湖万达广场	青山湖万达酒店
华山3日游	华山三日纯玩游
江西旅游路线	江西旅游攻略
青州市汽车站	青州市北站
深圳维也纳酒店 海雅	深圳酒店维也纳
坂田酒店	坂田附近的酒店
黄岛qu	黄岛区
温州汽车新南站	温州南站酒店
亚丁门票	亚丁景区
甲米 人妖秀	甲米表演
磐安跟团游	磐安旅游自由行
大兴安岭的门票	大兴安岭的当地玩乐
玉溪市红塔区	玉溪市红塔区人民政府
澳们流量	澳门流量
annata	anata
3星级酒店	4星级酒店
成都双流机场空港大酒店巨龙	成都双流机场空港酒店
塞班酒店	塞班岛自由行亲子
新乡佛力得宾馆	新乡佛力得假日宾馆
大漂流	漂流
自由行甘肃	甘肃旅游团
上海迪士尼乐园儿童	上海迪士尼儿童
五指山漂流一日游	五指山大峡谷漂流一日游
亲子度假酒店德清苏州	亲子度假酒店苏州
天津大学城 地铁站 酒店	天津市天津商业大学酒店
黄山市宏村住宿	黄山宏村景区酒店
杭州到杭州机票	杭州自由行机票
泉州晋江盈丰酒店	晋江盈丰精品酒店
纽宾凯希璞酒店武昌火车站	武昌纽宾凯
上海陆家嘴八佰伴CitiGO欢阁酒店	上海citigo欢阁酒店 陆家嘴
南昌万达广场附近的酒店	南昌万达酒店
敦煌雅丹地质公园	敦煌雅丹地质公园一日游
土楼田螺	田螺坑永定
王婷大酒店	王庭大酒店
上海杜沙夫人蜡像馆	杜莎夫人蜡像馆上海
Q家旅行	q家旅行
中山石岐商圈酒店如家	中山市如家快捷酒店
漯河市卡特创意酒店	漯河卡特创意酒店
普吉岛幻多奇乐园	普吉幻多奇
重庆亚朵S酒店	重庆渝北区亚朵酒店
纳菲尔酒店	拉菲尔酒店
江门新会火车站	江门新会汽车客运站
出门旅游必备	出门旅行必备
宁波到达州火车	宁波到达州
万卅大瀑布	万州大瀑布群
航司疫情政策	航司疫情
焦岗湖船票	焦岗湖游船
柃蜜小镇旅游度假区木屋	柃蜜小镇旅游度假区住宿
水市客舍	水市客舍酒店
泰国happy卡?	happy泰国卡
三亚aow潜水	三亚aow
大阪环球影城快速票新世纪	大阪环球影城快速票
千岛湖绿城喜来登度假酒店	绿城千岛湖喜来登度假酒店
惠州双月湾四人住	惠州双月湾4人房
冰川徒步 新西兰	新西兰冰川直升机
三亚金茂亚龙湾亲子酒店套餐万豪	三亚亚龙湾亲子酒店套餐万豪
贵阳市观山湖区北京路	贵阳观山湖
Qasis	oasis
韩国到青岛的机票	青岛到韩国飞机票
长沙周边一日游靖港古镇	长沙靖港古镇一日游
南京海底世界夜	南京海底世界
长春日租车	长春 租车
神龙架跟团游	神龙架旅游
兵马俑 车票	兵马俑直通车
拉萨跟团游五天四晚	拉萨跟团游5天
北京三环内的景点	北京三环景点
成都海昌海洋公园年卡	成都海昌极地海洋公园亲子年卡
泰国帝皇岛一日游	泰国帝王岛一日
丽江古城租电动车	丽江租电动车骑游
杭州到琼海	琼海到杭州
芜湖方特东方神话攻略	方特东方神话芜湖
江宁方山风景区	江宁方山
济南野生动物世界大门票	济南野生动物世界
惠州南昆山云顶温泉	惠州南昆山云顶温泉酒店
r艺术度假	r艺术度假酒店
迪士尼年卡	迪士尼 年卡
惠州巽寮湾金海湾喜来登晚餐	惠州金海湾喜来登度假酒店晚餐
香港兰桂坊团	兰桂坊香港
普吉出发曼谷两日游	曼谷普吉一日
中国人气旅游榜单	中国旅游人气
泉州十一中	泉州七中
星岛假日酒店	星岛假日
营口奕丰天沐温泉度假酒店	营口奕丰天沐温泉
凤娅山	凤垭山
长沙去海南	长沙到海南的
青岛泊居精栈	青岛china公社逸居酒店
东澳岛一起游	东澳岛一日
喆啡酒店(安阳文峰塔店)	喆啡酒店安阳
苏州呼伦贝尔大草原	草原呼伦贝尔大草原
张掖七彩丹霞冰沟丹霞	张掖冰沟丹霞门票
广州到南昌高铁	南昌到广州高铁
重庆市金佛山	重庆金佛山北坡景区
黄石滑翔伞	黄石跳伞
上海 全季	上海全季酒店浦东
西昌到成都车票	西昌到成都的火车票
六盘水的酒店西安民宿	西安酒店民宿
万达海洋公园	万达海洋
霍山大峡谷漂流一日游	霍山大峡谷漂流一日
马来西亚签证三年多次	马来西亚三个月多次签证
嵊泗酒店民宿	嵊泗本岛民宿
普陀山 跟团	普陀山二日游跟团
金茂凯悦丽江	丽江金茂凯悦
成都坐车配司机	成都租车配司机
千岛湖站	千岛湖广场附近酒店
鳌山湑水民宿	鳌山湑水名宿
沈阳热带雨林温泉酒店	沈阳热带雨林酒店
千岛湖森林氧吧住宿	淳安县-千岛湖森林氧吧附近的酒店
北京颐和安缦	北京颐和安缦酒店预定
江苏保险大厦酒店	江苏保险综合大厦
信阳市天润附近酒店	信阳东方红大道附近的酒店
北海一米阳光	北海一米阳光酒店
下日川	上日川
天饿湖	天鹅湖
唐山到定州	定州到唐山北
天目湖御水温泉度假酒店	天目湖御水温泉
常州的门票	常州景区
三亚怎么约跟拍	三亚跟拍
日本地配	日本地陪
汉庭酒店漕宝路店	汉庭漕宝路
无锡融创乐园3天2晚	无锡融创乐园三天
双西版纳双飞旅游	西双版纳双飞6日游
威海市立医院附近的酒店	威海海大医院附近的酒店
郑州西元国际广场	郑州万象城附近的酒店
西安机场内酒店	西安国际机场
重庆曼尼主题酒店	曼尼主题酒店重庆
邓州到东莞	邓州至东莞
敦煌西线嘉峪关张掖额济纳旗青海湖西宁兰州甘南新疆宁夏旅游专车	青海湖旅游包车自由行敦煌 张掖甘南兰州西宁额济纳旗代订包车
西宁大什字	西宁大什字附近的酒店
杭州开元森泊度假乐园自助餐	杭州开元森泊度假酒店自助餐
西塘悦己	西塘悦己精品民宿
苏州市博物馆门票	苏州博物馆需预约
南京老门东门票	南京老东门景点
广州番禺丽江明珠酒店	番禺丽江明珠
温岭 	溫嶺
洛杉矶环球影城双人	洛杉矶环球影城
襄阳浪漫满屋电影主题酒店	襄阳情侣酒店主题房
清迈野生动物	清迈野生动物园
鞍山千山温泉洗浴	鞍山千山温泉
福州溪山温泉度假酒店别墅	福州溪山温泉酒店
广州出发巽寮湾	广州巽寮湾往返
厦门圣希罗	厦门圣西罗酒店
广州长隆附近酒店亲子	广州长隆附近亲子公寓
移动wifi  越南	越南无线wifi
庐山包车自由行	庐山 包车
莫干山开元森泊水乐园幻想岛	湖州莫干山开元森泊幻想岛门票
栎社机场附近酒店	栎社机场T2
桂林阳朔县-遇龙河/十里画廊景区酒店	桂林阳朔十里画廊遇龙河店
杭州到宜宾的高铁	宜宾到杭州高铁
杭州市平海路附近的酒店	杭州平海路附近的酒店
半山花园	半山花园酒店
香港机场快线	香港 机场快线
青岛金沙滩附近的民宿	青岛金沙滩民宿
贝斯特韦斯特精品	贝斯特韦斯特
昆明到合肥自驾游攻略	昆明到合肥自驾游自由行
常州孟河镇酒店	常州孟河镇
滦县火车站	滦县火车站附近的酒店
南京如家新街口neo	南京市如家新街口酒店
曼谷打靶	泰国曼谷射击
抚州长途汽车站	抚州实验学校
京都 和服 跟拍	京都拍照
宁波景区度假民宿	宁波度假民宿
香港机场自取wi fi	香港wifi机场自取
洛阳克莉丝汀	洛阳克丽丝汀
迪士尼双人套票	迪士尼门票双人票
广元到旺苍	旺苍到广元
韩国酒店首尔	首尔 酒店
人民路酒店	人民路
太原市十六中	太原市四十八中
jr 关西 广域	jr广域关西
阜阳到马鞍山	阜阳到马鞍山的火车票
尚客优快捷酒店(扬州望月路店)	扬州优客尚品酒店
全季杭州西湖凤起路	全季杭州西湖中山北路酒店
银润锦江城堡晚宴	银润锦江城堡
常熟到东台	东台到常熟
泸沽湖自由行重庆出发	重庆泸沽湖双飞
郑州到guangzhou	郑州到广州
福士	福士酒店
中山张家边	中山张家边酒店
北京立水桥附近酒店	北京立水桥南附近的酒店
阿尔卡迪亚度假村	阿尔卡迪亚度假酒店
上海海洋水族馆外滩观光隧道联票	上海外滩观光隧道联票
黄花机场酒店	黄花机场
成都温江大学城附近民宿	成都温江区民宿
新加坡capella	新加坡capella酒店
千岛湖青旅	千岛湖青年旅社
秦皇岛周边游温泉	秦皇岛温泉
重庆解放碑威斯汀酒店全日餐厅	重庆解放碑威斯汀酒店
减500酒店	酒店500
普及海豚岛	普吉海豚岛
广州天河北路	广州天河北路酒店
大连 森林野生动物园	大连森林动物园
千岛湖 双十一	双11千岛湖
上海出发周庄一日游	上海夜游周庄
外伶仃岛旅游攻略	外伶仃岛攻略
桂平雅斯特酒店	雅斯特酒店 桂平西山店
长沙租车七座	长沙租车7座
老龙头门票团购	老龙头门票
聊城临清酒店	聊城山东省临清市火车站
广西南宁民族大学地铁口	广西南宁中医药大学明秀校区
黑白庙一日游清迈	清迈黑白蓝庙一日游
广东清远英德宝墩湖别墅度假区	清远英德宝墩湖别墅度假村
苏州山塘街早茶	苏州山塘街
兰州iu酒店	IU酒店·兰州高铁西站店
海口矿狂野水世界	海口狂野水世界
欧洲wif	欧洲wifi租
景洪泊度森氧全景度假酒店	景洪泊度·森氧VILLA全景度假客栈
永康汽车东站	永康站
日本签证三年多次	日本签证五年
北安到北京	北安至北京
横琴湾酒店套票	横琴湾酒店套票三天
绍兴三味书屋门票	绍兴三味书屋一日
普陀山百步阁宾馆	普陀山酒店百步阁酒店
伊犁那拉提风景区附近的酒店	伊犁那拉提镇
青岛红树林度假世界椰林酒店	青岛红树林度假世界（珊瑚酒店）
济州岛 拼车	济州岛拼车
澳門濠璟酒店	澳门濠璟
上海迪士尼导览	上海迪士尼乐园导览
栖梦 新月	栖梦·新月
普陀山亚朵	舟山普陀山亚朵
外滩旁边酒店	外滩附近的酒店
郑州大熊山	郑州一日游大熊山
温州锦江之星品尚酒店	温州锦江之星品尚
西江千户苗寨 酒店	西江千户苗寨观景台附近的酒店
浙江义乌民宿	浙江义乌的酒店民宿
湘潭步步高广场附近的酒店	湘潭北站附近的酒店
淮安周恩来故居酒店	淮安周总理纪念馆景区酒店
乐山大佛一日包车游	乐山大佛一日游成都包车
汕头南澳岛青澳湾节日	汕头南澳岛青澳湾
长春的汉庭酒店	长春汉庭
欣海酒店	欣海精品酒店
上海长隆野生动物园	上海野生动物园
四叶草	四叶草酒店
莲花山 温泉	莲花山度假村
九江庐山住宿	九江庐山风景区附近的酒店
安哥拉巨兔体验馆	安哥拉巨兔主题馆
境外流量包台湾	台湾流量包移动
福州三七巷	福州三坊七巷附近酒店
香港到泰国	香港飞泰国
无人三岛	三岛
西安大麦酒店大兴东路店	西安大麦酒店
宁波儿童水上乐园	儿童乐园宁波
广州西塱酒店	广州西塱
广州家华酒店	广州家华住宿
六盘水到贵阳高铁	贵阳到六盘水高铁
马屿镇酒店	马屿镇
青岛日照自由行三天	日照自由行三日
菲律宾宿务	宿务
北海涠洲岛看风景海边客栈	北海涠洲岛住宿一线海景
十堰周边游	十堰 周边 游
普吉岛秘密悬崖餐接送	普吉岛秘密悬崖餐厅
三丽鸥乐园	三丽鸥彩虹乐园门票
金华市义乌市	金华市义乌
怡家丽景酒店德阳	怡家连锁酒店德阳丽璟店
wifi环球漫游 日本	环球漫游wifi
邛崃市南街小学	邛崃市职业教育中心
宜春万达广场	宜春万达广场附近酒店
锡林郭勒草原自驾游	锡林郭勒盟锡林郭勒大草原骑马
双月湾海景度假屋	双月湾海景度假酒店
大阪到大连	大连到大阪
西藏 桃花	西藏桃花节
沈阳周边旅游	沈阳周边
巽寮湾金海湾度假酒店	巽寮湾金海湾
臻享海米酒店	臻享海米
湖州太湖风景区酒店	湖州 太湖旅游度假区 酒店
上海全季酒店中山公园	上海全季酒店中山西路店
天堂温泉酒店	天堂温泉度假村
维也纳酒店雅江	雅江维也纳
青海甘肃旅游西北大环线6天自由行	青海甘肃旅游西北大环线六天
广州塔附近的酒店公寓	广州市公寓酒店
洛阳柏菲美竞电竞酒店	洛阳柏菲电竞酒店
资阳客运站	资阳北站附近的酒店
意外险 旅游	旅游保险国内
松花湖宾馆北京	北京松花湖宾馆
昆明隐沫酒店	隐沫酒店（昆明高新区店）
香草航空行李额	香草航空行李
阳朔跟团	阳朔团
扬州景点联票	扬州门票
深圳四天三晚	深圳4天
广东周边温泉	广东省温泉度假村
普吉水上市场 一日	普吉水上市场
西安美居酒店	西安的美居酒店
沂水站	沂水汽车站
香港美荷	香港美荷楼青年旅舍
方特 水	方特水
九江小中房宾馆	九江中房宾馆
合肥蓝山湾门票	合肥蓝山湾
广州正佳极地海洋世界 亲子	广州正佳极地海洋世界
杭州市杭州电子科技大学下沙校区酒店	杭州市浙江理工大学下沙校区
H酒店常熟万达	H酒店 常熟
揭阳温泉酒店	揭阳盘龙湾
沈阳的锦江之星酒店北一路万达	沈阳锦江之星品尚
澳门电话卡联通	澳门电话卡自取
北京禧园	北京禧园酒店
鸡西到南京	南京到鸡西
美奈 半日游	美奈半日游
平南威斯丁	平南威斯汀
西溪去西塘	去西塘
石家庄情侣	石家庄情侣情趣酒店
漂流玻璃桥	玻璃漂流
南京中央路酒店	南京中央路
成都有什么好玩的地方	成都有什么好玩的
乌镇好玩吗	乌镇有什么好玩的
嘉兴乌镇开元曼居	嘉兴开元曼居
济南美得乐大酒店	济南美得乐
哈尔滨市内定制	哈尔滨内
丽思卡尔顿 海口	丽思卡尔顿海口
荆州市荆州区南环路1号	荆州市荆州区学苑路酒店
厦门日月谷温	厦门日月谷温泉渡假村
故宫博物院的	故宫
舟山市嵊泗县-花鸟岛酒店	舟山嵊泗县-花鸟岛酒店
梧州至重庆	梧州到重庆的火车票
上海海迪斯尼门票	上海迪斯尼门票
西安大差市酒店	西安钟楼大差市地铁站店
香港海洋公园套票深圳出发	香港海洋公园深圳湾
贵阳游玩	贵阳旅游
丹樱生态园的门票	丹樱门票
亚龙湾翡翠湾	亚龙湾翡翠谷
半潜艇夜观光	观光半潜艇
张家界攻略自由行	张家界自由行攻略
黄果树瀑布，荔波两日假	黄果树瀑布荔波二日
租佳能镜头	佳能镜头出租
Riz-Carlton	ritzcarlton
上海东方明珠门票旋转餐厅	上海东方明珠旋转餐厅双人票
99客栈	99旅馆连锁客栈
保定汉庭酒店	汉庭保定裕华西路火车站酒店
成都春熙路汉庭酒店	成都汉庭酒店
保利N+	保利N+酒店
厦门曾鼓浪屿919民宿	厦门民宿鼓浪屿
黔南民族医学高等专科学校	黔南民族师范学院
太平山顶 蜡像馆	太平山缆车蜡像馆
巴松措一日游	巴松措
安微新安江	安徽新安江
无锡市第四人民医院	无锡市中医医院
上海迪士尼乐园万怡酒店	上海万怡酒店迪士尼
上海海昌海洋公园主题酒店家庭	上海海昌海洋公园主题度
广州小情调青年旅社	广州回忆里青年旅社
三亚跟团游哈尔滨出发	哈尔滨到三亚跟团
笋岗地铁站	笋岗
民宿短租西双版纳	西双版纳民宿两室一厅
加拿大wifi	移动wifi加拿大
黄山山下酒店	黄山山下住宿
韶山景点	韶山门票
武汉长江豪华游轮	武汉长江游轮
上海三亚	三亚 上海
亳州到阜阳	滁州到阜阳
广州飞岳阳	广州到岳阳
天门南到武汉站	武汉站到天门南
半山半岛安纳塔拉度假酒店游泳票	半山半岛安纳塔拉度假酒店
马尔代夫joali	马尔代夫 ayada
鄂州住宿	鄂州站附近的酒店
半日门票	半天票
马来西亚签证半年多次	马来西亚一年多次签证
南宫温泉别墅	南宫温泉度假酒店
大理环洱海攻略	大理洱海攻略
哈尔滨万达融创茂	哈尔滨万达融创乐园大门票
恩施4日	恩施4日3晚游
三鑫	三鑫酒店
韩国乐天游乐场	韩国乐天世界游乐场
大连辉盛阁酒店	辉盛阁大连
爱尚主题公寓	爱尚精品公寓
到韩国的船票	韩国船票
庐山攻略自	庐山攻略
上海浦江夜游船票	上海浦江夜游游览船多人票
广州悦享	广州悦享酒店
西班牙牙签证	西班牙签证杭州
青海师范大学	青海师范大学新校区
大闸蟹自助餐	自助餐 大闸蟹
常州溧阳南山竹海	溧阳南山竹海门票
东莞中学初中部	东莞东城中学
青岛旅游一卡通年卡	青岛旅游年卡
广州长隆水上乐园门票绿	广州长隆水上乐园联票
南京汉庭酒店离湖南路	南京汉庭酒店湖南路
乌鲁木齐当地团	乌鲁木齐旅游
日本签证 东莞青旅	青旅签证日本
神龙架酒店景区附近	神龙架酒店
汉口到孝感东	孝感东到汉口
双十一预售 三亚	春节预售 三亚
乌鲁木齐 希尔顿	乌鲁木齐希尔顿
南通洲际酒店	南通滨江洲际酒店
大理菲宿民宿	大理菲宿
金莱卡酒店	金莱卡
北京双井地铁站酒店	北京双井酒店
苏州太湖民宿三山岛	苏州三山岛民宿
芭提雅3d艺术博物馆当日票	芭提雅3d艺术博物馆
三亚宋城旅游区彩色动物园	座位优选！宋城三亚千古情演出门票贵宾席彩色动物园景点景区套票
三亚浮潜一日游	三亚出海浮潜一日游
AHAO雅好花园酒店	ahao雅好酒店
华美达天禄	天禄
AOE	Aoe
刚察酒店	刚察蓝嘎布假日宾馆
晋城阳光大酒店	晋城市阳光大酒店
五星级酒店加自助餐	上海五星级酒店自助餐
格格兰云天酒店	格兰云天国际酒店
广西全景7日游	广西纯玩7日游
成都周边游达古冰川	成都一日达古冰川
长岛壹号院	长岛海景别墅65号院
涠洲岛一日游海钓	涠洲岛一日游浮潜
上海世茂精灵	上海佘山世贸精灵
崇明岛玫瑰	崇明玫瑰
海口市。	海口游
酒店套餐万豪	万豪 套餐
南澳岛海泉湾酒店	南澳海泉湾公寓
郑州幼儿师范高等专科学校	郑州商业技师学院
蚌埠到怀远	蚌埠到怀远县
北京5天4晚跟团游	北京旅游5天4晚跟团游
蓬莱观澜国际	蓬莱观澜国际酒店
租车兰博基尼大牛	租兰博基尼跑车
世纪华悦	世纪华悦酒店
iu武汉光谷店	iu酒店武汉
西昌一日游	西昌一日
桂林目的地跟团游	桂林四日游
湖南生物机电东湖校区	湖南生物机电职业技术学院东湖
杨州瘦西湖宿里民宿	杨州瘦西湖附近酒店 民宿
拉萨珠峰一日游	拉萨一日游跟团
长沙湖南警察学院酒店	长沙湖南工程职业技术学院酒店
六安火车站酒店	六安火车站附近的酒店
伊犁8日	新疆伊犁8日游
福州大学入台证	福州入台证
武汉游玩亲子年卡	亲子年卡武汉
普吉岛s 悬崖	普吉岛悬崖
京都浴衣	大阪浴衣
南浦客运中心	南浦客运站
点子导游	电子导游
上海到普陀山 船票	上海普陀山船票
四川省川剧院	成都四川省川剧院
昆明长水酒店 计时	昆明长水酒店
广州到云南跟团	广州到云南跟团游
东京到天津的机票	天津到日本机票
成都犀浦春天酒店	成都西南交大犀浦春天
横店影视城附近	横店影视
机场凯悦嘉轩	凯悦嘉轩机场
中國移动手机充值卡密	手机充值卡移动
西安体育学院含光校区附近酒店	西安文理学院科技一路附近酒店
珠海长隆海洋王国老人门票2日	珠海长隆海洋王国亲子二日两日门票
常德挑花源	常德桃花源
贵州省内游玩路线	贵州两天一晚跟团游
薛城区人民医院	薛城区的酒店
海南海口金牛岭公园	海南海口金牛岭
厦门去台湾旅游	去台湾旅游
金沙湾万豪	金沙湾万豪酒店
三亚特兰蒂斯酒店	三亚海南亚特兰蒂斯酒店
杭州到郑州东的火车票	杭州到郑州火车票
涠洲岛南国的孩子海岸民宿	涠洲岛南湾民宿
亚布力clubmed	clubmed 亚布力
贵州旅游景点地图	贵州小众旅游
成都春熙路名宿套房	成都民宿春熙路
黔南布依族苗族自治州福泉酒店	黔南布依族苗族自治州福泉市
海南皇马假日南海博物馆店	海口皇马假日南洋博物馆酒店
佛堂	佛堂附近景点
苏州甪直古镇门票	苏州甪直古镇
太原小店区康宁街酒店	太原小店区酒店
朔州开发区酒店	朔州的酒店
合肥安徽城市管理职业学院酒店	合肥安徽职业技术学院酒店
广州熊猫酒店美食小镇	广州熊猫酒店自助午餐小镇
皇逸良渚	良渚皇逸酒店
jrpass单程 关东	jrpass 关东
广州奇幻城堡酒店式公寓店	广州奇幻城堡亲子公寓
大理山吉	大理山吉客栈
合肥附近旅区	合肥附近旅游
娄山关路地铁站	娄山关 路 地铁 站
北京环球旅游度假区	北京环球度假区
肇兴侗寨栖兮	肇兴侗寨民宿
大理丽江泸沽湖吉普车	丽江泸沽湖吉普车
湖南张家界凤凰古	湖南长沙张家界凤凰古
南宁市民歌湖	南宁民歌湖
内江万达广场酒店	内江万达广场附近的酒店
银川南门广场	银川南门广场商圈酒店
兵马俑清华池一日游	飞猪专线陕西西安旅游兵马俑一日游跟团纯玩长恨歌骊山华清池门票
茂名北洛	茂名北路
兴义四中附近酒店	兴义客运东站
三亚专家楼海景酒店	三亚大东海专家海景酒店
泸沽湖二日游bikego	泸沽湖二日游 小团
东山岛铜陵镇民宿	东山岛铜陵镇住宿
桃花坞青年旅舍	桃花 坞 青年 旅舍
赣州游	赣州跟团游
北京站行李寄存	北京存行李
新大阪Shin-Osaka Hotel川西	新大阪酒店 hotel shin osaka
如家 安徽医科大学附属	如家安徽医科大学
长春市第四十八中学	长春市第五十六中学
安吉江南天池露营	安吉江南天池
重庆飘流	重庆漂流
民宿 北京	北京的民宿
聊城深海乐园	聊城海底世界
茶喀盐湖	茶卡盐湖
洪洞恋根快捷酒店	洪洞恋根
萍乡到南昌西	南昌西到萍乡北
惠州市惠城区演达大道	惠州惠南大道附近的酒店
速8酒店 武昌火车站店	速8酒店武汉武昌火车站
东方国际大酒店台州	台州东方大酒店
华南寺门票	华南寺一日
泰国一年多次商务签证	泰国一年多次旅游签证
涪陵九中	涪陵北站附近酒店
十堰至广州	十堰至广州火车票
芽庄 半自由行常州	芽庄自由行常州
日本旅游购物攻略	日本购物攻略
速8酒店 北京学院路	速8酒店北京学院
贵阳霏霏招待所	贵阳招待所
辉县八里沟	辉县八里沟景区
江西婺源开元酒店	婺源开元名都
秦皇岛北戴河海景酒店	北戴河海景酒店
格林豪泰快捷酒店无锡广瑞路	无锡格林豪泰酒店芙蓉路六路
北海道行程安排	北海道行程
河源中学	河源东源中学酒店
万达广场	万达广场附近酒店
四明山房车	四明山露营
单县汽车站	单县二中
漳州东山岛观涛公寓(马銮湾店)	漳州东山岛观涛公寓马銮湾店
圣地酒店	圣地 酒店
万州的民宿	民宿万州
沈阳希尔顿逸林酒店	沈阳的希尔顿酒店
青岛市崂山区民宿	青岛民宿 崂山区
夏门民宿	厦门的民宿
三亚机场太空舱	三亚太空舱酒店
荡口古镇酒店	荡口古镇
摘荔枝	荔枝采摘
杭州开元森泊度假	杭州开元森泊度假酒店套餐
益煌酒店	益煌精品酒店
珠海酒店浴缸	珠海浴缸
肇庆火车东站	肇庆火车站
上海长宁区临虹路酒店	上海市长宁区虹桥路
昆明欧椰时尚酒店	昆明欧椰酒店
阳江海陵岛北洛秘境悬崖泳池	阳江海陵岛闸坡北洛秘境度假酒
香港迪斯尼酒店	香港迪士尼酒店
年前旅游湖南	湖南旅游年
飞来峰解说	灵隐飞来峰
岳阳第十二中学	岳阳第十四中学
朱家尖岛屿精品民宿	朱家尖海边民宿
无锡植物大战僵尸僵尸玩具	无锡植物大战僵尸
湘潭雨湖区	湘潭湖南科技大学酒店
普吉岛攀牙湾半日游	普吉攀牙湾半日
德阳外国语小学	德阳科贸职业学院
巷里民宿	巷子里民宿
浙江到上海的火车票	杭州东到上海的火车票
11月去哪里	4月去哪里
香港海洋公园门票海洋快证7月	香港海洋公园门票快证
盐城周边游	盐城周边
青岛梦时代广场酒店	青岛城南区酒店
维尔纳国际酒店扬州	维也纳国际酒店扬州力宝广场店
福建龙岩	龙岩
郑州两日游	两日游郑州
石林竹海	石塘竹海
宁夏中卫沙坡	宁夏中卫沙坡头西坡
奉节酒店	奉节住宿
甘露园汗蒸	北京甘露园快捷酒店
长沙民宿两室	长沙民宿三房一厅
黟县宏村镇徽韵客栈	黟县宏村镇夜雨客栈
若 尔盖草原	若尔盖草原三日游
桂林3天2晚纯玩	桂林旅游3天2晚
中天凯悦酒店自助	中天凯悦酒店
普者黑 包车	普者黑一日游包车
金磊酒店	金磊国际
沂南第一中学	沂南火车站
宁波市眼科医院附近的酒店	宁波市中医院附近的酒店
惠州亲子酒店	惠州亲子房
清迈森林	清迈 森林
塑妍医疗美容	医疗美容
维也纳3好酒店（南昌梦时代谢家村地铁站店）	南昌维也纳3好酒店
上海周边游自驾	上海周边自驾两日游
长沙一日游韶山	长沙 一 日 游 韶山
一间森林 上海	上海一间森林酒店
南京khotel	khotel酒店南京
波格赛美术馆(Duplicate Key1)	波格赛美术馆
氹仔	仔仔
齐齐哈尔水师温泉住宿	齐齐哈尔水师森林温泉度假区
大理雲悦	大理 云 悦
从化温泉明月山溪独立别墅5	从化明月山溪独立别墅
新加坡科技馆门票	新加坡科技馆一日
北京到武汉的机票	武汉到北京机票
唐山市南堡开发区	唐山市路南区实验小学
富平中华郡圣温泉	富平中华郡圣温泉度假酒店酒店套餐
春秋航空券	春秋航空优惠券
安顺出发黄果树瀑布	黄果树瀑布一日游纯玩安顺
skr炫彩酒店	Skr炫彩酒店
安氡温泉度假酒店	氡温泉度假酒店
九鼎山云尚	九鼎山云尚度假酒店
佛山美的鹭湖温泉别墅	佛山美的鹭湖度假区别墅
合肥亚朵酒店马鞍山路	合肥亚朵
广州长隆水世界 大马戏套票	广州长隆水上世界大马戏
从江芭沙	从江芭莎
宁波到嵊泗列岛	嵊泗列岛宁波出发
川藏线5天	川藏线旅游五天
较场尾整栋民宿	较场尾民宿独栋
密室逃脱天津塘沽	天津密室逃脱
神农架林区九湖景苑酒店	神农架林区九湖镇湖景酒店
福建到昆明	福州到昆明
天津著名旅游景点	天津景点天津旅游
黄鹤楼附近美食	黄鹤楼小吃
郑州到深圳机票	深圳到郑州的机票
上海至成都飞机票	上海到成都的机票
温哥华机场接机	接机温哥华
成都吾留栖艺术公寓	成都吾留栖
银基冰雪世界亲子	银基冰雪世界
北京两夜自由行	二日北京自由行
新疆 亲子游	新疆 亲子
舟山普陀山大洒店	舟山普陀山酒店
洛阳嵩县白云山门票	洛阳嵩县白云山景区攻略
春秋航空行李额购买 泰国正品	春秋航空行李额泰国
惠安青山湾	泉州惠安青山湾
湖南财政经济大学	湖南财政经济
鑫河商务	鑫河商务宾馆
锦江之星鼓楼店呼合浩特	锦江之星呼和浩特鼓楼店
二中附近酒店	二中
青海儿童旅游小团	青海旅游小团
申根签证医疗保险	申根签证保险
长岛 攻略	长岛攻略
肇庆市将军山	肇庆将军山门票
古北水镇 函	古北水镇函
重庆time时光精品酒店	重庆时光酒店
重庆到铜梁汽车票	铜梁到重庆
石门县蓓	石石门
沃尔顿国际	沃尔顿
衡阳林隐假日酒店	林隐衡阳
淄博红叶柿岩	淄博红叶柿岩景区
海花岛希尔顿酒店	海花岛希尔顿双塔酒店
顺德勒流医院	顺德勒流
上海全季酒店合川	全季酒店上海虹桥合川路
深圳citigo欢阁酒店	深圳南山citigo欢阁酒店
四季云栖	四季云栖酒店
陵水分界洲海钓会所酒店	陵水分界洲海钓会所
巴尔干 流量卡	巴尔干半岛电话卡
大理皇朝大酒店	大理皇朝酒店
北辰大酒店	北辰
杭州丁桥	杭州丁桥酒店
北京赛瑞喜来登	北京喜来登
青岛华住会	青岛华住
杭州西湖酒店式公寓	杭州西湖景区边公寓
新加坡在线旅游签证	新加坡在线签证
海口市第四中学高中部	海口市第四中学初中部
万豪度假	万豪度假酒店
文昌 民宿	文昌名宿
亚龙湾维景国际	亚龙湾维景
广州珠海长隆旗舰店	广州长隆旗舰店
济南市历下区中润世纪广场	济南市历下区酒店
蓟县清真农家院	蓟县农家院清真
阜新附近温泉	阜新
太原实验中学	太原第十九中学
杭州珑璟心情民宿林语	杭州珑璟心情民宿（西湖林语店）
稻城 色达	色达 稻城
一日游石家庄	石家庄一日游石家庄
漫趣亲子主题酒店	漫趣亲子酒店
西溪湿地公园门票	西溪湿地船票
杭州大明山一日游	杭州周边游一日杭州出发大明山
南宁大学东路	南宁大学路酒店
花间堂通兑券	花间堂通兑
崇明船票	崇明 船票
越南芽庄电话卡杭州	越南芽庄电话卡机场
玉龙雪山跟团一天440	玉龙雪山跟团一日
北京长租	北京长租酒店
如新南湾海景酒店	如心南湾海景酒店
北京平安里如家驿居酒店	北京如家平安里地铁站
鼓浪屿 跟团	鼓浪屿跟团
杭州君悅	杭州市君悦酒店
台湾免税劵	台湾免税
三里屯酒店代订	三里屯酒店
舟山嵊泗列岛岛车船票	舟山嵊泗列岛船票
新疆包车拼车	新疆包车游
索舍2.0	广州素舍2.0酒店
奇台到乌鲁木齐	乌鲁木齐到奇台
贵州百里杜鹃风景区门票	贵州百里杜鹃风景区
普吉 伞	普吉岛拖曳伞
南昌八一广场的酒店	南昌八一广场地区 市中心
江门亲子游沙滩	江门亲子
西安索菲特酒店	西安索菲特人民大厦酒店
北京国际贵都大酒店	北京首都大酒店
昆明温泉山庄	昆明 温泉
江门自由行两天一晚	江门2天1晚
山海汇渡假海景酒店	山海汇观海公寓
惠州洲际度假酒店行政客房	惠州洲际的店
藏服	藏服租赁
官林格林豪泰	格林豪泰林
中华恐龙乐园门票	恐龙乐园门票
永年二中	永年第一中学
三亚 1hotel	三亚 1 hotel
成都游玩	成都游
骑大象普吉岛	骑 大象 普吉岛
铜陵北到铜陵	铜陵到
桃花岛往返船票	桃花岛船票船票
西安铁道技师学院附近酒店	西安铁道职业学校附近酒店
上饶职业技术学院附近的宾馆	上饶师范学院附近的酒店
杭州全季酒店武林路	杭州全季酒店武林广场
石狮华飞	泉州石狮华飞大酒店
同富公寓（深圳北站店）	深圳同富公寓
贵州地接	贵州旅游纯玩包车
安康市平利县酒店	安康市平利县
贵阳贵州医科大学南校区酒店	贵阳贵州民族大学新校区酒店
武汉高新大道潮曼	武汉高新大道潮漫
杭州桐庐独幽处	杭州桐庐独幽处民宿
惠州市惠东县热汤村温泉度假村	惠州热汤村温泉
抚仙湖国际旅游度假区	抚仙湖度假酒店
格鲁吉亚亚美尼亚签证	格鲁吉亚签证
广州到深圳包车	包车广州深圳
dongfmingzhu	东方明珠
临泽酒店	临泽的酒店
巢湖有那些地方好玩	巢湖当地玩乐
刚果(布)签证	刚果(金)签证
中国国旅新加波	中国国旅新加坡
园洲金莎酒店	金莎酒店
成都南充	四川南充
精途酒店虹梅榻榻米	精途酒店上海中环虹梅路店（原茜诺酒店）
长江壹号游轮	游轮长江
嵊泗本岛民宿毛毛屋	嵊泗东海渔村民宿毛毛屋
迪庆接机服务	迪庆接机
西塘良镶	西塘 良
三峡观坝风景区	三峡观坝一日
上海市金山城市沙滩酒店	上海金山城市沙滩附近的酒店
西安到广元高铁	西安北到广元
广州涉外经济职业技术学院(南校区)	广州现代信息工程技术学院
庐山漂流团	庐山漂流跟团
西安站附近民宿	西安北站附近民宿
福州2日游玩什么	福州二日游自由行
浙江绍兴职业技术学院	绍兴浙江工业大学之江学院附近酒店
广州到日本	广州至日本
珠海市拱北口岸7天优品酒店	珠海市7天酒店(珠海拱北口岸店)
星泰宾馆	星泰
安吉叁时	安吉叁時民宿
普吉岛 半自由	普吉半自由行六天五晚
广州火车东站附近的酒店	广州火车东站
古北水镇三人	古北水镇 三人
葡萄牙一日游	葡萄牙 一日游
天津滨海第二大街	天津开发区第三大街
深圳溢田附近酒店	深圳稔田酒店
三亚海南香水湾荣逸温情酒店	三亚香水湾荣逸温情
香港二十一菲威路	香港二十一威菲路
哈尔滨索菲亚教堂店附近的酒店	哈尔滨索菲亚教堂酒店
镇平服务区	镇平酒店
香港迪士尼乐园一日门票餐	香港迪士尼乐园门票含餐
广州长隆野生动物员门票	广州长隆野生动物门票
海南三亚海口租车自驾游5座	海南海口三亚租车自驾游7座
襄阳市第一人民医院	襄阳市第九中学
沈阳桃仙机场大巴到沈阳站	沈阳桃仙机场大巴几点
北海海景房酒店	北海 海景 房 酒店
东方影都万达水上乐园	东方影都万达水乐园
上海 迪斯尼 民宿	上海迪士尼附近的民宿迪士尼
厦门米宿民宿	民宿厦门
杭州酒店双十一	双十一杭州酒店
乌克兰旅游旅行团	乌克兰跟团游
厦门4天3晚自由行双人机票	厦门四日自由行机票
乌镇西栅黄粱一梦设计师酒店	乌镇黄粱一梦酒店
石阡温泉城	石阡温泉
西宁塔尔寺住宿	西宁珠穆朗玛宾馆
杭州昊颐酒店（转塘中国美院店）	杭州昊颐酒店
广州市中山大学附属第一医院	广州中山大学附属第一医院
三亚市海棠湾万达希尔顿	三亚海棠湾万达希尔顿逸林度假酒店
上海至成都飞机票	上海成都飞机
全季 古北	全季酒店古北店
贵阳贵州省机电学校酒店	贵阳贵州交通技师学院酒店
哈尔滨旅行攻略	哈尔滨旅游攻略
山东省青岛第四十七中学	山东省青岛第五十九中学
江门台山北陡	江门台山市北陡镇
梁平南站酒店	梁平南站
大理落落无尘	大理落落无尘海景客栈
澳洲4g卡	澳洲上网卡
琳宜酒店 北京南站店	琳宜酒店（北京南站店）
广佛通公交卡佛山	佛山公交卡
大连凯伦饭店	大连凯伦酒店
乐山峨眉私人导游	乐山大佛 导游
北京怡德医院酒店	北京北医三院酒店
五峰独领云顶酒店	五峰独领云顶
博泽精品酒店	博泽
锦绣香江里	锦绣香江
老君山半山腰酒店	老君山附近的酒店
大明湖火车站附近的酒店	大明湖附近的酒店
大同 温泉	大同温泉度假村
上海大学城	上海交通大学酒店
飞驒	飞 驒
拈花港	拈花湾 
王屋山知晓山居	王屋山知晓
童话秘境	童话密境
重庆解放碑n time	重庆N time
上海万信慧选国际旅游度假酒店	上海万信慧选
恩施大峡谷一日游私家团	恩施大峡谷一日游
三亚如家度假公寓大东海	三亚大东海如家酒店
去济南一日游	济南一日
丽江四方驿站	丽江四方驿栈
宁远县人民医院	宁远县第二中学
是极地海洋世界	极地海洋海洋世界
情侣情趣酒店贵阳	贵阳夜幕情趣微酒店
大理雪庐	大理雪庐民宿
穹隆山	穹隆山风景区
武汉新如家酒店佳园路	武汉新如佳酒店珞喻东路店
三亚湾红树林棕榈王国亲子酒店	三亚湾红树林度假世界棕榈王国
甲米sap	spa甲米
阜阳市阜阳职业技术学院酒店	阜阳市阜阳一中附近酒店
呼和浩特跟团游5天4晚	呼和浩特5日游
万宁石梅湾艾美别墅	万宁石梅湾艾美酒店
成都大邑花水湾金陵酒店	成都花水湾金陵温泉度假酒店
南湖公园酒店	南湖酒店
三亚亚龙湾吉阳区	三亚 亚龙湾 吉阳 区
嵩山滑雪	嵩山滑雪场
北海涠洲岛住宿南湾	北海 涠洲岛 住宿 南湾
保定四季童话小镇酒店	保定四季童话小镇
新基业假日酒店	新基业假日
广州野生动物园地铁口	广州 野生 动物园 地铁 口
合肥海底世界门票	合肥海洋馆门票合肥海底世界
初喜民宿	初喜生活民宿
珠海到明珠	明珠到珠海
昆明大板桥附近酒店	昆明大板桥地铁站
北京租车去长城	北京租车长城
丽江丽豪假日一号	丽豪假日丽江
广州到珠海长隆 	珠海长隆大巴
三亚海悦臺	三亚 海悦 台
杭州市萧山区朝晖初中	杭州萧山区第一中等职业学校酒店
西安北站汉庭酒店	西安北大街汉庭酒店
成都名宿可以做饭	成都可以做饭的民宿
安州区酒店	安州区汽车站
汉庭武林广场东	汉庭武林广场
苏州 园林	苏州园林旅游
三亚市三亚亚龙湾美高梅度假酒店	三亚亚龙湾美高梅度假酒店玩乐套餐
成都创布	成都创布酒店
象山皇冠假日	皇冠假日酒店象山
上海黄铺大林路265号	如家上海陆家浜路地铁站店
厦门花石客栈	厦门花客栈
草原天路住所	草原天路住宿
毛家峪漂流农家院	毛家峪农家院
建德 开元	建德开元
三亚 美高梅 亲子房	三亚美高梅亲子游
曲江大道极地海洋馆	曲江海洋极地馆
金边le mont hotel	tama hotel 金边
大柴旦万发酒店	大柴旦万发假日酒店
黄浦江游船 龙船	龙船黄浦江
普吉蛋岛皮皮岛一日游	普吉岛皮皮岛蛋岛
德庆盘龙崃	德庆盘龙峡
一呆公寓大理滨海俊园	大理滨海俊园
大理古城栖南理客栈	大理古城栖南理精品客栈
重庆市内一日游。	重庆市内纯玩跟团游
八达通ka	八达通卡
日照开元	日照东湖开元
长沙方特水上乐园	长沙方特水上乐园门票
孔府孔庙孔林一日游孔孔庙	孔庙一日游
万安酒店	万安的酒店
阳朔租电动车	阳朔租车电瓶车
日本漫游卡	日本手机漫游
大侠谷酒店	大侠 谷 酒店
厦门半自由行五天四夜半自由行	厦门旅游五天四晚自由行
澳门签字	澳门签证
希腊土耳其轻奢	土耳其轻奢
三亚慢走慢游民宿	三亚旅游民宿
扬州到天津	天津到扬州
苏州游玩路线	苏州游玩
44w精品酒店w	w精品酒店
深圳夏威夷国际酒店	深圳夏威夷酒店
仙本那潜水体验	仙 本 那 潜水 体验
铭湖温泉门票	铭湖门票
贵阳到重庆西的火车票	贵阳北到重庆的高铁
大理弥渡酒店	大理弥渡宾馆
天津机场vip休息	天津机场贵宾休息室
长春南关区酒店	长春市南关区人民大街
凯里大酒店	凯里 酒店
潮汕青旅	潮汕 青旅
旺角攻略	旺角自由行
西安丽晶酒店	西安钟楼丽晶酒店
南京新街口诺富特	南京诺富特
香格里拉沪沽湖	泸沽湖 香格里拉
惠州南昆山十字水生态度假村电话	惠州南昆山十字水生态度假村惠州
如皋南	如皋汽车客运站
情趣酒店苏州	苏州情趣酒店
江津汽车站	江津客运中心
安徽境内三日游	安徽省内三日游
喀什市当地游当地玩乐	喀什当地玩乐
贵阳5星级酒店	贵阳五星级酒店
西安戴森酒店 大雁塔店	戴森酒店(西安大雁塔南广场店)
云台山2日游门票	云台山2日游
德国签斯图加特	德国斯图加特
济南方特东方神画大门票	济南方特东方神画
三亚海棠湾摩托艇	三亚摩托艇
沧州洗浴中心	沧州温泉
岳阳南湖公园附近酒店	岳阳市湖南理工学院酒店
北京丰台区小屯路	北京市丰台区小屯路89号
广州融创嘉华酒店	广州融创嘉华
杭州市萧山机场附近宾馆	杭州市萧山机场附近酒店
重庆大足一日纯游小团	重庆大足一日游
北京到爱丁堡	爱丁堡到北京
枫林酒店	枫林
吉安安福武功山酒店	吉安安福武功山
三亚旅游纯玩跟团	三亚跟团游
深圳初见客栈	深圳初见
贵州一日游梵净山	贵州梵净山一日游
青海湖倒淌河景区	青海湖倒淌河
响水到淮安	淮安到响水
武汉傅家坡客运站店	武汉傅家坡客运站
日本 移动 wifi	移动日本wifi
公主轮阿拉斯加	阿拉斯加公主号
鼓浪屿   船票	鼓浪屿船票
新西兰移动wi-fi	新西兰移动wifi租赁
澳门住哪里	澳门住
三亚海边海景度假酒店	三亚酒店海边酒店
香港迪士尼 三合一套票	香港迪士尼门票三合一
丽江晨 精品客栈	丽江精品客栈
重庆山也白盒子	重庆山也白盒子民宿
日本环球影城eva快速票	环球影城日本快速票
昆明云南艺术学院附近的酒店	昆明云南师范大学商学院酒店
巴厘岛金巴兰rimba漂浮	巴厘岛金巴兰rimba
哈尔滨西站到哈尔滨站火车	哈尔滨西到哈尔滨站
上海迪士尼首推半年卡	迪士尼半年卡上海
南田温泉度假区	南田 温泉 度假 区
成都东站如家爱尚	如家成都东站
尾单特价泰国苏梅岛	尾单特卖苏梅岛
云臻金陵翠云山酒店	云臻金陵翠云
广东风景区	广东 风景 区
聊城盛景温泉酒店	聊城盛景温泉酒店门票
奥维斯	奥维斯精致
滑石寨门票	滑石寨
德天瀑布夜场	德天瀑布门票
哈尔滨玻璃栈道爬山	哈尔滨玻璃栈道
长春到广州的机票	长春到广州机票
古兜温泉旗舰店	古兜温泉门票
曲阜孔庙酒店	曲阜孔庙宾馆
碧桂园独栋别墅咸宁	咸宁碧桂园温泉城柏林别墅
极乐汤 金沙江路	金沙江路极乐汤
钟山风景区门票	钟山风景区
越南老街l	老街越南
驾驶证认证	驾驶证本
遵义两日游	遵义跟团2日游
杭州武林广场附近的酒店	杭州武林广场商圈酒店
上海深坑洲际	上海世贸深坑洲际酒店
西双版纳全季	西双版纳 全季酒店
贵阳火车站附近酒店如家酒店	如家酒店贵阳高铁北站
全季马甸桥	全季北京马甸桥
泰和山风景区风景区	泰和山
微思豪	微思豪酒店
邢台临城崆山白云洞	河北邢台临城崆山白云洞门票
丰苑酒店	丰 苑酒店
东方盐湖城盐	东方盐湖城
武功山君澜附近	君澜武功山
上海三只小熊国际青年旅舍打浦桥	上海三只小熊国际青年旅舍
烟台大学附属中学	烟台职业学院
绍兴沁颐酒店 柯桥银泰店	绍兴沁颐酒店
周边游跟团漯河	跟团游漯河
长沙出发自驾三天两晚游	长沙三日自由行
广州长隆野生动物世界二日门票	广州长隆野生动物世界二日一日
西双版纳帕雅客栈	西双版纳帕雅泰国风情客栈
郑州陌上酒店	郑州陌上轻居
新加坡国郭河畔	新加坡国敦河畔大酒店
商丘到巨野	巨野到商丘
华中师范大学南湖校区酒店	华中师范大学南湖校区(北门)
杭州出发周庄	杭州周庄
合肥 亲子	合肥亲子游
温泉清河半岛	清河半岛温泉
诸暨市客运中心	诸暨客运中心
青岛即墨金山滑雪	青岛金山滑雪场
附近的名宿	附近名宿
佛山顺德美的万豪	佛山美的万豪
深圳天龙居旅馆	深圳天龙居宾馆
景点杭州	杭州的景点
韶关莱斯丽呈	韶关莱斯丽呈华酒店
珠海 美食	珠海美食
江门台山尾角湾	江门台山尾角湾民宿
南昌滕王阁地铁站	南昌滕王阁酒店
如皋江安镇酒店	如皋的酒店
武隆天坑一日游	重庆武隆天坑一日
大连金石滩沙滩浴场	大连金石滩浴场
南京二日游自	南京半自助二日
iu长沙火车站	iu酒店长沙火车站店
芜湖万春花园附近的酒店	芜湖中医药高专附近的酒店
重庆医科大学附近酒店	重庆人文科技学院附近酒店
苏州吴江区民宿	民宿苏州
海南三亚全家游	三亚全家自由行
跟团游纯玩北京老人团	跟团游纯玩北京
天瑞国际酒店	天瑞酒店
酒店招远	招远温泉
广州酒店民宿	广州名宿
宏村留白寒舍美宿	宏村留白寒舍·茶·民宿
印江到遵义	遵义到印江
丽枫荆州	荆州丽枫酒店
澳门万豪酒店联票	澳门酒店万豪
贵阳贵州中葡星酒店	贵州中葡星酒店
华中科技大学主校区	华中科技大学东校区
河南大学	河南中医药大学
靖航古镇	靖港古镇
济洲岛北京	济州岛北京
长沙理工大学云塘最近	双树公寓酒店长沙理工大学云塘店
响沙湾莲花酒店家庭	莲花酒店响沙湾
昆明到腾冲的汽车票	昆明到腾冲的火车票
珠海恒仁洲际酒店	珠海仁恒洲际
宁国夏霖民宿	安徽宁国夏霖民宿
五一上海周边游	2日游 上海周边
林坑太合堂	林坑太和堂
兴城海边度假村	兴城度假村
大连二天一夜周边游	大连二天一夜二日
日本插座转换器	日本转换插座
梅州丰顺鹿湖温泉别墅	梅州丰顺广东鹿湖温泉假日酒店
莫林精选酒店长沙	莫林精选酒店长沙五一广场
厦门迦逅	厦门迦逅雅居
深圳铂斯登行政公寓	深圳铂斯登行政公寓深圳南山
传媒大学地铁站	传媒 大学 地铁 站
北京02轻奢	北京02轻奢酒店
qian户苗寨	千户苗寨
马尔代夫亲子岛	马尔代夫亲子
广州至西安游	廣州到西安
怀来景点	怀来旅游景点
澳门怎么换澳币	澳门旅游换多少澳门币
大庆林甸温泉欢乐谷门票	大庆林甸温泉欢乐谷
新乡医学院三全学院平原新区	新乡医学院三全学院附近
上海杭州两日游	杭州出发上海两日游纯玩跟团游
云南旅游团购	云南精品团
祁红国际	祁红国际大酒店
上海交大宾馆	上海交大地铁站
武汉icc	icc武汉
成都国色天乡三期童话世界	成都国色天乡童话世界
全季酒店丰庄	全季丰庄店
珠海长隆两天一夜自驾	珠海长隆二日
深圳飞美国	美国飞深圳
北戴河鸽子窝	秦皇岛市北戴河鸽子窝酒店
澳门机票 买一送一	澳门买一送一机票
海珠湿地公园套票	海珠湿地公园
广州去香港机场	广州至香港机场
澳门一日旅游攻略	澳门一日游跟团游
常州中华恐龙园门双人	常州中华恐龙园双人
索菲亚民族成都	成都索菲斯民族大酒店
朱家角铂尔曼	上海朱家角铂尔曼
苏州乐园森林水世界门票晚上	苏州乐园森林水世界两日游
一日游毕棚沟	毕棚沟一日游
乐山市太和盛	乐山太和盛世大酒店
滑雪温州	温州室内滑雪
西北大环线含机票自由行	大西北大环线自由行
三亚国际免税店	三亚 国际 免税 店
天籁之梦湖州太湖别墅度假酒店	天籁之梦湖州太湖温泉别墅度假酒店
三亚市温泉酒店	三亚  温泉
美那多 ow	美娜多aow
泰国签证进度查询	泰国纸质签证
慈溪包车	慈溪 包车
洪湖电竞酒店	洪湖电竞
清溪漂流	深溪漂流门票
人妖秀巴东	芭东人妖
汕头礐石风景名胜区附近的酒店	汕头礐石风景
松山湖 温泉	松山湖温泉酒店
杭州五日游攻略	杭州5日游当地跟团游
鳌山滑雪场一日	一日游鳌山滑雪场
兴国到萍乡	萍乡到兴国
上海宛平路600号	上海宛平南路600号
岘港自由行南京出发	岘港南京出发
义乌汉庭酒店	义乌汉庭
大同周边旅游	大同周边游
搜游三亚	穷游三亚攻略
张家界国家森林公园附近酒店	张家界国家森林公园酒店
飞猪万豪国际集团旗舰店	飞猪万豪旗舰店
包车 杭州	大巴车包车杭州
民俗八坊十三巷	八坊十三巷
大连浪漫满屋体验馆	大连浪漫满屋主题公馆
珠海海洋科学馆	珠海海洋科学
手机卡英国	英国giffgaff电话卡
福朋酒店	福朋
福州希尔顿欢朋	福州希尔顿酒店
重庆到桂林	桂林到重庆
阜阳到昆山	昆山到阜阳
新希望诺富特酒店	新希望诺富特
max蹦床主题公园	max蹦床
全季酒店五一路	全季酒店五一广场
泰国华欣酒店	华欣住宿
北京家庭式公寓	北京 家庭 式 公寓
泰国曼谷导游地陪 女	曼谷地陪
庐江到合肥	合肥到庐江的汽车票
三亚悦榕庄会员卡	悦榕庄三亚
温州嘉运大酒店	温州嘉运
杭州浙江工业大学屏峰校区旅馆	杭州工业大学屏峰校区酒店
航班时实动态	航班实时动态
万豪早餐券	万豪自助餐券
六鳌翡翠湾滨	六鳌翡翠湾
卢沟湖青旅	泸沽湖旅社
广州奥园城市天地酒店	广州奥园广场酒店
西安金桥旅游专营店	[西安送签]韩国 签证个人旅游免押金加急陕西甘肃宁夏
博鳌万慕酒店	博鳌万慕
广州长隆水上乐园门票酒店套票	广州长隆水上乐园门票双人票
武隆渝珠花园酒店	重庆武隆渝珠花园酒店
重庆市洪崖洞附近酒店	重庆市洪崖洞酒店
南宁北海游	南宁北海旅游攻略
曲阜三孔电子讲解	曲阜三孔景区讲解
青城山山野	青城山山舍
深圳w	w酒店深圳
都江堰青城豪生	青城豪生
苏州到福州	福州到苏州
万宁租车摩托车	万宁租车敞篷跑车
永兴县	永兴县的酒店
珠海香港	香港珠海
北京当地6天5晚酒店套餐	北京六日酒店套餐
大理下关经济开发区附近的酒店	大理下关明珠广场附近酒店
清明自由行	清明
海南至北海的船票	北海到海南的船票
北京公主坟	北京公主坟酒店
新疆自驾地图	新疆自驾游车队
海南三亚亚特兰蒂斯酒店	海南 三亚 亚特兰蒂斯 酒店
江苏南通海安	江苏省南通市海安县
台北小巨蛋站附近民宿	台北小巨蛋民宿
杭州湖滨银泰民宿	杭州西湖湖滨银泰名宿
广州到厦门的高铁票	广州到厦门高铁票
厦门金门跟	厦门跟团金门
重庆天幕酒店	重庆天慕酒店
茂名广东石油化工学院	茂名广东石油化工学院官渡校区第一教学楼酒店
哈尔滨到福州的火车票	哈尔滨到福州火车
合肥瑶海区电竞酒店	合肥南站电竞酒店
山东省济南第五中学	山东省济南第二十中学
武汉周边个人游	游武汉周边
打洛口岸八角亭	打洛独树成林
芭堤雅 spa	芭提雅按摩
clubmed joy	clubmedjoyview
佛山同济路酒店	佛山南桂路酒店
重庆解放碑新华酒店洪崖洞	重庆解放碑新华酒店（洪崖洞店）
风竹自助餐	沨竹自助
波罗蜜多酒店自助餐	波罗蜜多自助晚餐
都江堰大熊猫一日游	都江堰熊猫基地一日游成都
瑞士一地跟团深度游	瑞士跟团
北京张莹公寓	北京公寓
北海海钓	北海出海钓鱼
曼谷自由行仅机票	曼谷自由行机票
合肥出发九华山	九华山二日游合肥出发
羊湖半日游环湖	羊湖纯玩半日
广州天河城	广州天河城附近的酒店
日本5年签证父母	5年日本签证
龙岩市中山路步行街	龙岩市第一医院附近的酒店
哈尔滨太空舱酒店	哈尔滨太空舱
日本迪迪士尼	日本亲子迪士尼
巴厘岛 当地游玩	巴厘岛当地玩乐
北海涠洲	广西北海涠洲岛
曼谷住在哪	曼谷住
普吉岛半自由行无边泳池酒店	普吉岛自由行无边泳池酒店
成都世纪城会展中心酒店	成都世纪城新国际会展中心酒店
北京跟团	组团北京
十年签证	10年签证
清远接送	清远大巴
丽枫酒店广州天河太古汇	丽枫酒店广州天河体育西
阳朔遇龙河索道	阳朔游遇龙河
漳州恒悦主题酒店	漳州恒悦酒店
上海迪斯尼迪士尼乐园门票早享	上海迪士尼早享票
深圳民宿短租	深圳短租民宿
凤凰古城到重庆	重庆到凤凰
温岭到杭州东站	温岭站到杭州
上海迪士尼乐园电话	上海迪斯尼电话
河北满山花溪谷	河北花溪谷
丽江 纯玩	丽江纯玩旅游
遵义七天连锁酒店	遵义七天优品酒店
阿尔山林缘度假山庄	阿尔山林生度假山庄
九寨沟回武汉	武汉九寨沟
深圳旅游景区	深圳景区
珠海凤凰湾	珠海凤凰湾酒店
海洋公园观光餐厅	海洋公园餐厅
济宁博雅公寓式酒店	济宁博雅酒店
瓦特兰蒂斯酒店水世界门票	瓦特兰蒂斯酒店水世界
石门县北站	石门县酒店
万香苑	万香苑酒店
衡山酒店	衡山景区
义乌水族馆	义乌海洋馆
惠州市中级人民法院	惠州市第一人民医院附近的酒店
普陀山南普山庄 贵宾楼	普陀山南普山庄（贵宾楼）
西宁二日游 大巴	西宁二日
度蜜月巴厘岛	巴厘岛自由行
退票须知	退票规定
贵阳民宿家庭套房	贵阳的民宿
惠州两天	惠州2日
扶风县的酒店	陕西扶风县
武汉汉正街地铁旁如家酒店	武汉汉正街如家酒店
漳州漳浦七星海	漳州七星海
全季酒店上海康桥秀沿路店	全季上海康桥秀沿路
皇后镇luge滑板车票	皇后镇luge滑板车
广州融创堇山酒店自助餐	广州融创堇山酒店自助晚餐
龙宫颠	龙宫
后海地铁站	后海地铁站住宿
深圳直飞机	深圳飞机
平度电竞酒店	平度电竞
上海莫奈花园酒店	上海 莫奈 花园 酒店
厦门机场接送机	厦门接机送机
三亚自由行一晚	三亚2天2晚
全日空行李	全日空行李额购买
菲律宾签证广州阳光	菲律宾广州签证
内蒙6天5晚	内蒙六天五夜
北京自由行5天4晚酒店双飞	北京旅游5天4晚自由行酒店
厦门去我家精品名宿	厦门去我家精品民宿
龙门南昆山民宿	龙门南昆山居
盐城彼时云墅	盐城彼时云墅酒店
上海迪斯尼乐园附近民宿酒店	上海迪斯尼附近民宿
郑州方特欢乐世界夜场大门票	郑州方特欢乐世界门票夜场
去西藏攻略	西藏旅游旺季旅游攻略
青海曼巴旅行社	青海曼巴旅游行
厦门石门植物园	厦门植物
中国 湖州 花筑·奢南浔沉香酒店(原赏玉阁沉香酒店)	湖州花筑奢南浔沉香酒店湖州赏玉阁
上海月星环球港酒店	上海月星环球港
长春=哈尔滨	长春哈尔滨
古韵长安旅游	古韵长安旅游旗舰店
稻荷院	荷院
速8酒店(地坛公园西门店)	速8酒店地坛店
芽庄酒店场地酒店	芽庄酒店
天津亿利精灵	天津亿利精灵乐园
欧尚主题酒店	欧尚酒店
黄浦江夜游船票	夜游黄浦江船票
西双版纳租车smart	西双版纳敞篷租车
深圳南山前海亚朵	深圳南山亚朵S酒店
昆山到浦东机场	昆山到上海浦东机场
昆明石林九乡一日游纯玩小团	云南旅游昆明出发石林九乡一日游
汉庭 珠海	汉庭珠海
足球赛事	足球
南京鼓楼区中央路酒店	南京鼓楼区中山路酒店
桐庐民宿别墅独栋	桐庐民宿别墅
兴隆希尔顿逸林	兴隆希尔顿
通化市第五中学	通化市第二中学
中国渔村大门票	中国渔村
三亚better海景公寓	三亚ihome海景度假公寓
西安天悦酒店大明宫西店	西安天悦
金佛山 北坡	金佛山北坡景区
龙华中路	龙华中路地铁站
酒店x新动力广场	酒店新动力广场
商丘火车票	商丘到
宁波鄞州区下应区附近的酒店	宁波鄞州区酒店
沙县淘金山门票	沙县淘金山一日
深圳南山区民宿复式	深圳北站名宿
老君山君山怡景	老君山君山度假公寓
重庆到成都游玩？	成都重庆游
拍照打卡	拍照
十二背后客栈	十二背后 客栈
桂林维也纳酒店市政府	桂林维也纳酒店中山中路
天津五大道	天津东丽区
西安  壶口瀑布	壶口西安
杭州岚山居 山上民宿	杭州岚山居 山下民宿
广州去香港直通车	广州香港直通车巴士
千岛湖饭店	千岛湖大酒店
佛冈白云温泉	佛冈白云温泉山庄
舟山朱家尖乌石塘海景酒店	舟山朱家尖景区乌石塘
广州山居瓦舍	广州山居 瓦舍简奢艺术民宿
建发酒店旗舰店	建发旗舰店
临沂市临沂地下大峡谷酒店	临沂市沂水县山东地下大峡谷酒店
长沙湘雅二院酒店	长沙湘雅附一酒店
宜思特酒店	宜思特
云端精品	云端酒店
太古里成都	成都太古里
天津奥城商业广场A4	天津奥城商业广场
西安五路口 地铁站 汉庭酒店	西安汉庭公园南路
乌石天成台	乌石镇天成台
天水秦州区宾馆	天水秦州区酒店
佛山南海自助餐	佛山自助餐
西安钟楼回民街附近的酒店	西安钟楼附近的酒店
汉庭上海世博杨思酒店	汉庭酒店上海世博杨思店
常州武进新城希尔顿	常州新城希尔顿
盐城旅游景点	盐城的门票
三亚瑰丽酒店 海棠湾	三亚三亚湾瑰丽
成都包车西藏	西藏旅游包车成都出发
大疆osmo口袋相机	大疆相机
威海市大水泊机场酒店	山东威海大泊水机场
重庆三峡中心医院	重庆市肿瘤医院
长沙酒店三人房	长沙五一广场酒店套房
深圳下沙民宿	深圳沙井民宿
九洲驿站树屋英德	英德九洲驿站
凡辰	凡辰酒店
石家庄河北经贸大学学府路酒店	石家庄河北科技大学酒店
冲绳大和鲁内	冲绳县厅大和roynet酒店
广东南方职业学院	广东工程职业技术学院
海口可以做饭的长租房	海口短租公寓做饭
佛山别墅酒店	佛山度假别墅
天津航母主题公园	天津航母公园
嘉兴漂流	嘉兴周边漂流
去日本的船票	到日本船票
浙江到成都的机票	杭州到成都机票
沈阳辽宁金融职业学院酒店	沈阳辽宁装备制造职业技术学院
杜莎腊像馆	杜莎蜡像馆
伦敦进爱丁堡出	爱丁堡伦敦
曼谷素万那普xiuxi	曼谷素万那普
渭南市区酒店	渭南信达广场酒店
天津天塔今日牛	天津金日牛夜宾馆
儿童室内游乐园	儿童游乐场
安徽温泉度假村	安徽温泉度假酒店
稻城亚丁海螺沟	稻城亚丁 海螺沟
旅拍香格里拉	香格里拉旅拍
安吉滑雪泡温泉	安吉滑雪温泉
北京橘子水晶酒店安贞	桔子水晶酒店北京安贞店
乐山峨眉山旅游攻略	乐山峨眉山攻略
大连海之缘酒店式公寓	大连海之缘酒店式公寓星海广场
南宁艾美酒店	艾美酒店南宁教育路
芬兰航空wifi	芬兰wifi
北海–涠洲岛	北海涠洲岛
汉庭四牌楼	汉庭酒店四牌楼
爱之初	爱之初酒店
深圳市蛇口港码头酒店	深圳市深圳蛇口码头酒店
自由潜深圳	深圳深潜
珠海长隆企鹅酒店套票3天两晚	珠海长隆企鹅酒店套票3天2晚家庭
中山泉眼温泉附近酒店	中山泉眼温泉
涪陵武陵山  大裂谷攻略	涪陵武陵山大裂谷
颖亦皇冠假日酒店	颖奕皇冠假日酒店
北欧九又四分之三	北海九又四分之三
眉山亲子游	亲子 眉山
黄果树瀑布一日游门票	黄果树瀑布一日游一日
温州华润万象城	温州万达广场
热气球 天目湖	天目湖氦气球
清迈出发海岛	清迈海岛
深圳卓越国旅宝安专营	深圳卓越国旅专营店
广东财经大学	广东财经大学华商学院
阿坝达古冰山	阿坝达古冰川
东京去草津	东京草津
蚌埠主题酒店	蚌埠情侣主题酒店
电话卡印尼	印度尼西亚电话
邮轮  春节	歌诗达邮轮
霸州日月潭	霸州日月潭温泉
广州去从化	酒店从化
西安铁一中	西安省汽车站
成都双流体育中心周围酒店	成都双流中心公园酒店
哈尔滨莱客时尚艺术酒店火车站店	哈尔滨莱客
香港迪士尼乐园探索家早餐券	香港迪士尼乐园探索家早餐
北山湾旅游度假区附近的酒店	北山湾海景
安徽黄山漂流	黄山景区漂流
wifi国内租赁	国内wifi
济南东站附近酒店	济南东站
北京两市三日游	北京二日游
如家 上海 大连路	上海如家大连路
重庆飞日本	重庆飞东京
福州平潭酒店	福州平潭县
marina bay sands	Marina Bay Sands
厦门如家酒店海沧	厦门的如家酒店
赫尔格达的当地玩乐	赫尔格达当地玩乐
成都特色小吃街	成都特色小吃
普吉岛人妖表演秀	普吉岛西蒙人妖表演
净隅酒店（郑州中原福塔店）	郑州净隅酒店未来北路店
乌龙木齐	烏魯木齊
密云县	密云的酒店
大同一日游纯玩团	大同一日一晚游云冈石窟
嘉定万怡酒店	嘉定万怡
固原市第八中学	固原市第三中学
广州南到英德	广州南到英德的火车票
当天可定 上海迪士尼门票上海迪士尼乐园门票1日门票 1日票电子票	当天可定上海迪士尼门票上海迪士尼乐园
成都春熙路附近景点	成都东站附近的景点
启东恒大海上威尼斯酒店全套	启东恒大海上威尼斯酒店别墅
西安出发周边一日游	西安一日游
珠海长隆海洋王国交通	珠海长隆海洋王国老人票
海口市琼山中学（高中部）	海口市琼山华侨中学
池州旅游	池州周边游
惠州巽寮湾中航元屿海星缘运动度假酒店	惠州巽寮湾中航元屿海度假酒店
韶关风度	韶关风度名城
希尔顿欢朋酒店 台	希尔顿欢朋酒店
奉贤上海之鱼	奉贤区上海之鱼
北京动物园门票+	北京动物园门票
湖南长沙旅行团	湖南长沙跟团4天3晚游
南疆旅行	南疆跟团
桂林阳朔新富安大酒店	桂林阳朔西街新富安大酒店
太阳山小镇	太阳山度假小镇
南京到临沧	临沧到南京
阳光海悦半岛酒店	海悦半岛酒店
宁波自驾游一日	宁波自驾游
全季酒店 三亚	全季三亚三亚湾酒店
武汉户部巷雅斯特酒店	雅斯特武汉解放大道
深圳外伶仃岛酒店海岛游自由行	外伶仃岛深圳
大秦温泉养生园	大秦温泉养生苑
广州露营酒店	露营广州
青岛自由行日本机加酒	机加酒自由行日本
撗店	櫎店
新加坡签注	新加坡过境签证
上海一日游跟团旅游含东方明珠杜莎夫人蜡像馆	上海杜莎夫人蜡像馆东方明珠一日
台湾元旦三日游	三日台湾
长白山拼车延吉	延吉到长白山拼车
广安市广安区宾馆	广安宾馆
宁波大榭客运站附近的酒店	宁波汽车北站
澳门水舞	澳门水舞间门票 
北港村住宿	北港村
米兰圣托里尼	米兰 圣托 里尼
西安市西安思源学院酒店	西安市西安交通工程学院酒店
如家精选酒店千岛湖	如家精选-杭州千岛湖景区店
长沙跟团直升机	长沙直升机体验
山东航空行李	山东航空行李托运
西塘古院庭院精品酒店	西塘古月庭院精品客栈
石家庄合作路	石家庄和平西路
郑州浴缸房	郑州浴缸酒店
杭州吴山夜市酒店	杭州吴山夜市附近的酒店
桐庐虎跳峡	桐庐虎跳峡漂流
湖南张家界美食	张家界美食
飞猪下载	飞猪app
长春吉林财经大学	长春吉林外国语大学酒店
旬阳到西安	西安至旬阳
凤凰古城住宿民宿沱江虹桥	湖南凤凰古城沱江民宿
九寨沟到都江堰	九寨沟都江堰小团
苏州市温德姆酒店	苏州温德姆酒店
徐州无眠连锁酒店高铁站店	无眠徐州高铁站酒店
低空旅行	低空旅游
君悦莱	君悦莱酒店
上海牛路野营	帐篷上海
广州亚朵S	广州亞朵
南京绿博园门票	绿博园南京
天涯海角潜水票	天涯海角潜水
拉萨怡程酒店	怡程酒店拉萨
日照金马三区附近	银座佳驿日照山东路店
浙江房车露营基地	房车营地 浙江
重庆长安	重庆长安酒店
宏村在水一方酒店	宏村在水一方民宿
泰安万达广场5号公寓	泰安万达公寓公寓六号
宁波象山两日游	宁波象山跟团两日游
温州机场附近宾馆	温州机场附近酒店
杭州宋城景区门票和酒店	杭州宋城景区酒店
开封TL酒店民宿龙亭公园店	tl民宿开封龙亭公园店
泰谷签证	泰国签证
上海仁济医院西院门诊部酒店	上海仁济医院西院
成县到陇南	成都到陇南
张家界山水中天	张家界山水中天酒店
成都蒸汽旅馆	成都蒸汽旅舍
青岛市斯维登酒店	青岛斯维登会展中心
南京夫子庙美食街	南京夫子庙附近
长江邮轮豪华游五天	长江 5日 游轮
普陀山吴淞码头船票	吴淞码头到普陀山船票
广州 郑州	广州郑州
亚布力温泉国际度假中心	亚布力温泉酒店
青岛正阳路酒店	青岛正阳中路
高阳县的酒店	高阳县人民法院
大理云上四季快捷酒店	大理云上四季酒店
上海市徐汇区枫林路附近的酒店	上海徐汇区枫林路
禾尖s	禾尖S酒店
俄罗斯纯玩	俄罗斯跟团游纯玩
遂宁高升实验小学校酒店	遂宁一中学
电话卡香港	香港流量电话卡
易佰天津西站经济型	易佰天津西站
维也纳国际酒店长乐爱心路	长乐维也纳
中山大学附属第三医院附近酒店	中山大学附属肿瘤医院
贵阳医院	贵阳市第二人民医院
香港旅游自由行成都	香港自由行成都
玉山县火车站的酒店	玉山县城酒店
西塘池尚	西塘
亚庀仙本那	仙本那
海底世界广州	广州海洋王国
🇬🇧	� � � � � � � �
云南弥勒湖泉酒店	弥勒湖泉酒店
长江三峡自驾	三峡大坝自驾游
新疆旅游包车包司机	新疆旅游司机
中改院	中改院酒店
丽江车站	丽江火车站附近酒店
兰州万达嘉华	兰州万达文华酒店
九曲湾温泉酒店	九曲湾温泉
台州上海自由行	台州自由行
焦作云台山风景名胜区门票	焦作云台山门票
珠海游乐场	珠海游乐园
青岛开放大学	青岛大学附近的酒店
阿尔罕布拉宫门票	阿尔罕布拉宫讲解
宜春滑雪温泉	宜春滑雪
北海围洲岛船票往返+上岛费	北海去围洲岛船票
成都套房酒店	成都酒店套房
华尔道夫酒店成都	华尔道夫成都
泰国旅行需要带	泰国旅行带
黄山丰大浩瀚天下冲浪	黄山丰大浩瀚天下
惠州团体游	惠州团
新疆两日游	新疆伊犁两日游
新加坡吉隆坡巴士	新加坡去吉隆坡
香港迪士尼一日快速门票	香港迪士尼一日门票
杭州下沙漫时光别墅轰趴3	杭州下沙漫时光别墅轰趴
凯信酒店	凯信精品酒店
最美湘西	魅力湘西
皖南自驾	皖南自驾游
烟台租金	烟台租赁
北京乌鲁木齐机票	乌鲁木齐机票
张家港市金凤凰温泉度假村	张家港金凤凰
台湾跟团游全自由	台湾自由跟团游
亚航行李额  马来西亚	马来西亚行李额
成都市海伦酒店	海伦
普吉岛巴东邦格拉泰拳	普吉岛巴东泰拳
硬石大连	硬石酒店大连
上海的旅游路线	上海旅游路线
bustour观光巴士	bustour
无锡市惠山区酒店	江苏省无锡市惠山区
威海福地源酒店	威海福地缘温泉大酒店
广州从化顺翔酒店	从化顺翔
运城人民公园	运城第一医院
贵宾休息室乌鲁木齐	乌鲁木齐贵宾室
重庆解解放碑	解放碑重庆
厦门豉浪	厦门鼓浪
上海迪士尼乐园一日儿童票1元	上海迪士尼一日儿童票
海南自由潜	海南 自由 潜
杭州三墩金地广场亚朵酒店	杭州亚朵酒店上塘路
深圳南山人民医院	深圳市第二人民医院
海南南湾绿城威斯汀	海南蓝湾绿城威斯汀
宜必思尚品西安大兴东路酒店	宜必思酒店西安北站店
苏梅岛潜水	苏梅岛南苑岛一日游
虹桥火车站到浦东机场	上海虹桥火车站到浦东机场
佳能g7x3	佳能g7x
重庆到日本的机票	重庆到日本机票
欧洲婚纱	欧洲婚纱照
郴州市内游玩	郴州当地玩乐
泰国度假	泰国亲子度假酒店
拉萨锦江之星酒店	拉萨锦江之星品尚
安远三百山温泉景区附近的酒店	安远三百山温泉度假酒店
天津血液病研究所附近的酒店	天津眼科医院附近的酒店
张家界大栈道玻璃桥门票	玻璃桥门票张家界
罗托鲁瓦蒂普亚毛利文化村	罗托鲁瓦毛利文化村
rv房车露营	rv房车
三亚海棠湾恒大养生	海南三亚海棠湾恒大养生谷
乌镇西栅风景区内酒店	乌镇西栅景区内酒店
北京妇产医院东院	北京儿童医院
青海guo敦煌大环线	青海敦煌大环线
从化千龙沟门票	从化千泷沟门票
汉庭南京南艺	汉庭南京南
翻译软件	翻译工具
香港过境旅游票	香港过境票
阳朔桂花巷国际青年旅舍西街店	阳朔青年旅舍
三亚亚特兰蒂斯酒店餐厅	三亚亚特兰蒂斯酒店自助餐
长隆大马戏一等座	长隆大马戏vip座
东方文廷酒店	东方文廷大酒店
北京英语导游团	英语导游北京
万豪 自助餐	万豪酒店自助餐
一日游包头	包头周边一日游
春节北海道自由行	北海道自由行春秋
喀纳斯禾木	新疆喀纳斯禾木
哈尔滨榛果名宿	哈尔滨民宿
上海亚朵酒店青浦区	上海亚朵酒店闵行北路
济宁美食	济宁自助午餐
广州长隆水上乐园门票夜场单人	广州长隆水上乐园门票情侣夜场
网诗园	网师园
洪山区珞狮南路	洪山区珞喻路
南京方源国际酒店	南京方源金陵国际酒店
古龙峡漂流团票	古龙峡漂流团
南坪酒店	南坪
湖北神农架	神农架
上海到苏州包车	苏州上海包车
沈阳北站到桃仙机场	沈阳站到桃仙机场
上海迪士尼乐园门票二大二小	上海迪士尼乐园门票二日
贵州梵净山自由行攻略	贵州梵净山2日游
深圳宜必思酒店	宜必思深圳
兵马俑大巴	兵马俑 车
广州希尔顿逸林酒店早餐	广州希尔顿逸林酒店
莲花山风景区	莲花山
朱家尖海景度假酒店	朱家尖海景酒店
锦江之星郑州火车站二七广场店	锦江之星酒店郑州文化路店
初见精品酒店	初见酒店
旅行团山东	山东旅行
故山民宿	故山生活
惠州到北京	北京到惠州
松江河客运站	松江河站
越南电子签证杭州	杭州越南签证
衡水冀州酒店	衡水冀州
penzance	Penzance
芜湖市中心酒店	芜湖酒店 
三亚市三亚亚龙湾红树林度假酒店	三亚亚龙湾红树林度假酒店海景
青岛如家精选酒店	青岛的如家酒店
港澳境外移动wi fi	港澳境外随身wifi租赁
上海出发绍兴	上海出发绍兴两日游攻略
吉庆街丽枫	丽枫酒店吉庆街
枸杞岛 酒店	枸杞岛民俗
蜈支洲岛租船	蜈支洲岛船
贵宾室 香港	香港贵宾休息室
长春夜市	长春商场
重庆浴缸民宿	重庆名宿浴缸
兵马俑《秦》剧	兵马俑票
上海迪士尼乐园一日门票周末	上海迪士尼度假区1日门票
威尼斯酒店公寓	威尼斯国际酒店公寓
广州金莎大酒店南沙店	广州金莎
第二海水浴场青岛	青岛第一海水浴场酒店
北戴河 度假	河北秦皇岛市北戴河度假酒店
厦门世纪环岛酒店	厦门世纪寰岛酒店
桂林阳朔4日游跟团	桂林阳朔跟团游4天3晚
内蒙古阿拉善	内蒙古阿拉善左旗
科逸连锁酒店苏州汽车南站店	科逸连锁酒店(苏州教育园店)
京都伏见稻荷	京都 伏见 稻 荷
大理丽江定制游	大理丽江纯玩
福州到厦门飞机	厦门到福州飞机
南湖温泉国际酒店	南湖温泉国际
长春像素公馆酒店式公寓	长春像素公馆
上海迪士尼乐园附近民宿亲子	上海迪士尼乐园周边民宿酒店
澳门氹仔到港澳码头	澳门 凼 仔 到 港澳 码头
天府七中	天府新区附近酒店
浙江大学华家池校区卡特楼	浙江工业大学屏峰校区
香格里拉去丽江	丽江去香格里拉
佰程 韩国签证	韩国签证简化
千岛湖家庭	千岛湖 家庭
海口到深圳的船票	深圳到海口的船票
全季上海人民广场酒店	全季酒店上海外滩人民路店
西安自驾游旅游攻略	西安自驾游攻略
深圳罗湖口岸进地铁站	深圳罗湖地铁
北方暖暖温泉洗浴	北方暖暖洗浴中心
留学签证日本	日本留学签证代办
东晓南公寓	东晓南酒店
承德跟团游	承德旅游
富春江开元	富春江开元酒店富春江
奥园喜来登	奧園喜來登
santosa新加坡	sentosa新加坡
宁波艺术青藤	宁波青藤艺宿清水铺店
珠海长隆迎海酒店公寓2天1晚4r	珠海长隆二日两日迎海酒店
双十一必买	双十一买买买
广州正佳东方国际广场	广州正佳广场
宜昌三峡游一日	宜昌三峡大坝一日游门票
襄阳到徐州	徐州东到襄阳
长滩岛白班	长滩岛白班机
西双版纳安塔纳拉	西双版纳安纳塔拉
苗浦路151号	苗圃路151号
桔子水晶酒店 	桔子水晶 
如家快捷酒店杭州滨江星光大道	如家精选酒店(杭州滨江星光大道店)
松江河站	松江河火车站
密云海湾半山酒店	北京密云海湾半山酒店
老君山 里苏	老君山里苏名宿
迪士尼再见双11	双11迪士尼
哈尔滨发云南	哈尔滨飞云南
太子公寓	太子酒店公寓
天津大麦66LiveHouse酒店	天津大麦66LiveHouse汉庭
盐城市人民政府	盐城市
上海人气景点	上海人气一日
肥东火车站	肥东一中
杭州杭颐酒店	杭州和颐
山西办泰国签证	泰国签证山西
送机 芭提雅	芭堤雅机场接机
美国电话卡香港自取	美国电话卡自取
济南东方神话露营	东方神话济南
汕尾水底山温泉酒店庄园	汕尾水底山温泉
新城吾悦广场青岛	青岛吾悦广场酒店
东圃天河城	天河公园/东圃商圈附近的酒店
桂林 别墅	桂林别墅
飞猪流量巴厘岛	飞猪巴厘岛
芭提雅let's  relax 	let s relax芭提雅
马尔代白马庄园	马尔代夫白马庄园
上海大自然野生昆虫馆学生票	上海上海大自然野生昆虫馆
融城欢动世界游乐园	融城欢乐世界
苏州华谊兄弟苏州电影世界	华谊兄弟苏州电影世界
北京农业大学西校区	北京中国农业大学西校区酒店
山东职业学院	山东科技职业学院
肇庆鼎湖山附近的酒店	肇庆鼎湖山酒家
开元大酒店 杭州	杭开元大酒店
西宁城北万枫	西宁城北万枫酒店
汉庭天津塘沽洋货市场酒店	汉庭酒店天津塘沽外滩店
庐山西海温泉假日酒店	九江庐山西海国际温泉酒店
montigo	montigo resort
香港迪斯尼快速	香港迪士尼乐园
新乡开元名都大酒店	新乡开元
西尔蒙花园	西尔蒙花园精品
上海迪斯尼乐园乐拍通	上海迪士尼乐拍通一日通一卡通
南昌市城市便捷酒店	城市便捷酒店 南昌火车站店
苏州观前街附近酒店	苏州 观前街
流量卡以色列	以色列电话卡
台湾跟团游纯玩杭州出发	台湾跟团游纯玩广州
福州大学附近酒店	福州广播电视大学
中国移动境外流量泰国	泰国境外流量包中国移动
阳江海陵岛保利度假村国际公寓	阳江保利海陵岛度假村酒店公寓（十里银滩P区店）
蓝沐	蓝沐酒店
广西柳州卡乐星球门票	柳州卡乐星球欢乐世界
国际流量日本	日本国际流量
宁波方特周边景点	宁波方特门票
如家精选酒店 郑州cbd	如家精选酒店郑州
大理独栋别墅	大理 别墅
衡阳市区酒店	衡阳酒店
河北省承德市	承德市避暑山庄
大连希岸	希岸酒店(大连软件园理工大学店)
西安金茂酒店	金茂酒店西安
武夷山周边一日游	武夷山景区一日门票
青海zizhu	青海自助
迎客莱	迎客来
通渭悦心温泉水世界	通渭悦心温泉水世界门票
长沙市开福区人民法院附近酒店	长沙市六中附近酒店
乌镇独栋别墅民宿	乌镇大墅民宿
哈尔滨到齐齐哈尔机票	齐齐哈尔机票
韩国 好玩的地方	韩国门票
清远漂游一日游	清远漂流一日
桂林北到龙脊梯田专线车	桂林火车站到龙脊梯田
湖南洞口	湖南洞口酒店
大唐芙蓉园的夜场票	大唐芙蓉园
临沂市电子科技学校	临沂市技师学院北校区
广州七天客村地铁站店	7天连锁酒店广州客村地铁站
梵净山云舍民宿	梵净山云舍村
扬州望潮楼大酒店	扬州东关街望潮楼文化主题酒店
汤口酒店	汤口镇
三亚贝斯特韦斯特精品酒店	三亚贝斯特韦斯特精品国际度假
琼海嘉悦酒店	琼海和悦
澳大利亚旅游签证	澳大利亚签
深圳较场尾民宿整栋	深圳较场尾民宿
l0黄金海岸	黄金海岸0
10月蜜月	十日蜜月
岳西景点	岳西旅游景点
皮皮岛的酒店	甲米皮皮岛酒店
八达岭长城一日团	北京八达岭长城一日游跟团
国庆自由行长春	长春自由行
上海东方肝胆医院附近酒店	上海东方医院南院附近酒店
之花一世界	一花一世界
绍兴有啥好玩的	绍兴门票
长沙一日包车游纯玩	长沙一日包车
鑫成凯瑞	鑫城凯瑞
菲律宾薄荷	菲律宾 薄荷
深圳欢乐顾	深圳欢乐谷
太原山西机械高级技工学校酒店	太原山西财政税务专科学校酒店
湖州伯爵世家酒店(海兴路店)	湖州伯爵
大阪一日券海游馆	日本大阪海游馆一日
青岛黄岛区黄海学院	青岛滨海学院
乐陵的酒店	乐陵汽车站
湖南警察学院附近的酒店	湖南警察学院
宁波海海洋世界	宁波世界海洋
天目湖山水园门票水上世界	天目湖水世界门票
衢州东方广场酒店	衢州国金中心附近酒店
天津度假酒店	天津度假村
遂昌到宁波	宁波到遂昌
秦皇岛全季酒店	全季酒店秦皇岛
天津方之眼	天津之眼
三亚海棠湾留下小筑	三亚海棠湾留下小筑主题民宿
龙岩云顶	龙岩 云 顶
广东东莞海洋馆	东莞海洋馆
跟团游马来西亚	沙巴亲子游马来西亚
郴州雾漫小东江客栈二号桥	郴州雾漫小东江
腾冲瑞丽西双版纳	腾冲芒市瑞丽西双版纳
兴城国际大酒店	兴城大酒店
红旗精选酒店	红旗
到凤凰古城	凤凰自由行
芽庄自由行签证	签证越南芽庄
峨眉山 维也纳	峨眉山维也纳
萧山长途汽车站	萧山汽车站
杭州 q加	q 杭州
玉龙雪山通票	玉龙雪山 票
东海周边游	东海跟团游
陆丰到深圳北的火车票	深圳北到陆丰的火车票
重庆一夜游	夜游重庆
咸宁到阳新的汽车票	咸宁到阳新
海曙区	海曙区第三医院
湖北黄石国家地质公园	湖北省黄石市旅游景区
皇岛精品酒店	皇岛
夏威夷茂宜岛月亮湾浮潜	夏威夷月亮湾浮潜
黄山市田家炳中学	黄山市汽车客运总站
四姑娘山景区酒店	四姑娘山酒店
青岛dujia	青岛度假
莫意民宿	莫意精品民宿
胶州公寓	胶州北
港澳台通行证续签	港澳通行证续签
昆山市维也纳酒店	昆山维也纳酒店市政府
日上95折	日上免税店优惠券
关山牧场星空	关山牧场
郑州新郑机场到商丘汽车票	商丘到郑州再到新郑机场高铁
南京师范大学新北校区	南京师范大学附属实验学校
北京站到天安门	北京西到天安门
6蓬莱文成城堡	蓬莱文成城堡
鼎龙湾希维尔海景别墅	鼎龙湾希维尔
惠州市温泉门票	惠州温泉门票
三亚海棠亚特兰蒂斯酒店	三亚海棠湾亚特兰蒂斯酒店套餐
虹桥火车站接送	虹桥 火车 站 接送
北京旅游一日	北京一日游纯玩
按摩保健会所	附近按摩保健会所
北京百顺快捷酒店	北京百顺酒店
重庆美宿酒店	重庆美宿
溪中溪	溪 中 溪
北京证仁医院附近酒店	北京同仁医院南区
连平县的酒店	连平县
宁诲五山石窟门票	宁诲五山石窟一日
峨眉山金顶住宿离金顶近	峨眉山近金顶住宿
厦门五缘湾凯悦	厦门五缘湾凯悦酒店
金饶山门票	金饶山一日
海口美食城	海口自助午餐城
邮轮 赞礼号	赞礼号
深圳丽枫酒店坂田	深圳丽枫
英山温泉壹号酒店	英山 温泉 一号 酒店
确山县第二高级中学	确山县的酒店
移动临时电话卡	国内电话卡
绿源假期酒店	绿源酒店
锦江都城大酒店	锦江都城酒店
铜川陈炉	铜川陈炉古镇酒店
三峡人家门票+往返车票	[三峡人家-大门票]含渡船票
西安火车站附近宾馆	西安火车站
迪士尼美食8折券	迪士尼美食券
上海戏剧学院莲花路附近的酒店	上海市上海戏剧学院酒店
西安4天自由行	西安自由行4天
上海锦江之星酒店曹安路	上海锦江之星地铁站
西宁城市职业技术学院	西宁第一职业技术学校
芽庄自由行尾单上海	上海尾单自由行
新疆滑雪场	滑雪 新疆
辽宁滑翔伞	滑翔伞辽宁
花都附近好玩的地方	花都当地玩乐
大流量卡	纯流量卡
深圳北到晋江	晋江到深圳
茶芽山	楂岈山
舟山到花鸟岛	舟山花鸟岛车船联票
牡丹江到郑州	牡丹江至郑州
深圳泰国普吉岛海边别墅	泰国普吉岛海边别墅
昆明南部客运站附近旅馆	昆明市行政中心附近旅店
洛杉矶 迪斯尼	美国加州迪士尼
奚口老街	溪口老街
绵阳南山中学本部	绵阳实验小学
保定易县酒店	保定易县
珠峰大本营一日游	珠峰大本营三日
惠州旅行团	惠州跟团游
天津和平区滨江道	天津滨江道步行街
日照桃花岛赶海	日照桃花岛船票
日本4g卡 自取	日本电话卡樱花卡
尚瑞	尚瑞酒店
珠海海泉湾度假酒店	珠海海泉湾旅游度假区
八宿然乌湖国际	八宿然乌湖
鹏润国际大酒店	鹏润国际酒店
聊城的酒店汽车西站	聊城建设东路附近的酒店
西塘民宿	西塘古镇民宿
中山艾美酒店自助餐	中山保利艾美自助餐
四川两日游	四川两日
成都宽窄巷子希尔顿欢朋	成都希尔顿欢朋酒店
尚客优快捷酒店泉州钟楼店	泉州尚客优
武汉中南地铁站	武汉中南路地铁站附近酒店
成都机场假日	成都机场假日酒店
接机服务宁波	宁波机场接送机
河南信阳师范学院	信阳师范学院东门
广州越秀区凯瑞酒店	广州凯瑞酒店
游泳馆天津	天津游泳
国庆小众景点	国庆冷门景点
泰国ais电话卡	泰国AIS电话卡
上海f1国际赛车场	上海 f 1 国际 赛车 场
美豪丽致酒店杭州武林广场旗舰店酒店套餐	美豪丽致杭州武林广场
吉林市雾凇岛	吉林雾凇
重庆酒店2晚	重庆酒店套餐重庆2晚
武广	武广酒店
宝鸡周边一日游宝鸡出发	一日游宝鸡出发
卡帕多奇亚 越野	atv 卡帕多奇亚
马鞍山市第二十二中学附近酒店	马鞍山市第二十二中学
秦陵兵马俑	秦时皇兵马俑
尚du嘉年华	尚都嘉年华
忻州市忻州职业技术学院酒店	忻州市忻州师范学院酒店
山西省眼科医院	山西省中医院
云和泊夜酒店	云和泊酒店
兰州民宿家庭房	兰州民宿
广州增城金叶子酒店	增城金叶子酒店
龙泉创e家酒店	创e家酒店
佘山门票	佘山附近景点
青旅长沙	长沙旅舍
桂林东西巷舍	桂林东西巷附近民宿
陇南武都宾馆江都	陇南武都区碧海快捷宾馆
香港如心海景酒店暨会议中心自助歺	香港如心海景酒店暨会议中心酒店
大理缘梦岛花园海景客栈	大理双廊梦缘岛花园客栈
沙巴市水上清真寺	沙巴水上清真寺
莫干山群安里度假酒店	莫干山君安里
湖州3天2晚自由行	浙江湖州双人3天2晚
虹桥北商务宾馆	虹桥商务宾馆
广州小屋酒店沙埔店	广州小屋
观澜湖荒野水上乐园	水上乐园观澜湖
上海南站附近的酒店	上海南站
老君山附近的酒店	老君山景区内住宿
重庆市重庆渝中区酒店	重庆市渝中区大坪酒店
武汉出发张家界	武汉出发张家界跟团游
浦江仙华山	浦江仙华山景区
fz	Fz
武汉到重庆邮轮	武汉至重庆长江邮轮
三亚海景国际酒店	三亚海景国际度假酒店
贵阳美食街	贵阳美食夜市
亚特兰蒂斯 c秀	亚特兰蒂斯c秀表演
郑州航空港区万怡酒店	郑州空港万怡
香港直通大巴	香港直通车大巴
泰安火车	泰安高铁
深圳市上步北路2008号银湖大厦	莫泰-深圳八卦岭红岭北路店
台湾住海洋公园	台湾海洋公园
岳麓山 	岳麓山国家
苏梅丛林飞跃	苏梅岛丛林
郑州到夏门北	郑州到厦门北
上海奥特莱斯	上海奥特莱斯购物
乌镇半日	乌镇西栅半日游
厦门t4机场附近宾馆	厦门t4飞机场附近的酒店
阜阳橙子酒店	阜阳橙子商务酒店
桂林灵川县酒店	桂林灵川县附近的酒店
手机卡日本	日本电话卡流量
廊坊全季酒店	廊坊全季
西安白鹿之隐温泉房车营地	西安白鹿之隐温泉房车度假营地
金山寺镇江	镇江风景区金山寺门票
无锡五日	无锡 五 日
邢台火车站	邢台东站
福建龙岩连城天一温泉	龙岩连城天一温泉住宿
上海松江区旅游景区	上海松江旅游
福州新店森林公园	福州森林公园
肇庆湛江一日游	肇庆一日
弗思特连锁酒店	弗思特
山西临汾广胜寺	山西广胜寺
南阳地铁站	南阳汽车站附近的酒店
哇哩哇国奇妙	哇哩哇国
无锡市太湖风景区酒店	无锡太湖鼋头渚景区内酒店
照相厦门婚纱旅拍	旅行拍婚纱照厦门
丽江木府闲院	丽江木府闲院酒店
丽江出发泸沽湖	丽江到泸沽湖跟团
包车海口	海口包车司机
上海市崇明区	上海崇明区
第十七中学	第十一中学
题日本签证	日本签证日本
丽江古城酒店 希尔顿	丽江希尔顿花园酒店
汉庭无锡火车站南广场酒店	汉庭无锡
南京宁波	宁波南京
南溪江民宿	楠溪江住宿
成都蜀汉路一品天下酒店	成都市一品天下地铁站酒店
壶关大峡谷门票	壶关门票
余姚班玛:家民宿丨稻田里	余姚班玛家民宿稻田里
广东十大景区	广东景点
四川城市职业技术学院	四川现代职业学院
九寨沟亚朵轻居	九寨沟亚朵酒店
西安大雁塔喷泉表演	西安大剧院演出
上海 冰雪奇缘	冰雪奇缘上海
alpensia 雪	alpensia 滑雪
安吉迈岚度假酒店	安吉迈岚酒店
秦皇岛人民广场区酒店	秦皇岛市区酒店
黄山风景区南门附近的酒店	黄山风景区附近的酒店
9月份	11月份
艾希	艾希酒店
南京水上乐园	水上乐园南京
乐山大佛门票和船票	乐山大佛游船船票
广富林宰相府	广富林宰相府酒店
苏州市苏州同里古镇旅游区酒店	苏州同里古镇内住宿
曼斯顿大酒店	曼斯顿
西安临潼悦椿	临潼悦椿酒店
联通香港流量	香港流量联通
烟台开发区喜来登酒店	烟台喜来登酒店
达古冰川门票	达古冰川
摩洛哥突尼斯跟团游	摩洛哥突尼斯
哈尔滨济南	哈尔滨 济南
迪斯尼法国	法国迪斯尼
接送接机	机场接送机
遂昌凯	遂昌凯兴假日酒店
临沂动植物当地玩乐	临沂动植物园当地玩乐
延庆好玩的地方	延庆区的门票
普尔漫	普尔曼
桂林东西巷附近的酒店	桂林正阳街
清远佛冈碧桂园温泉度假别墅	清远佛冈碧桂园温泉度假酒店
潢川景点	潢川的当地玩乐
隐世叠院儿	隐世 叠院儿
湖州市安吉欢乐风暴水上乐园酒店	湖州安吉欢乐风暴水上乐园门票
三亚华宇亚龙湾迎宾馆国光	三亚亚龙湾华宇迎宾馆
香港l签证送签	签证香港送签
广州长隆野生动物世界门票 大马戏	广州长隆野生动物世界门票二日
日本探亲签证	日本探亲
烤苹果乐园	烂苹果乐园
樱花节日本	樱花 节 日本
昆明滇池海埂公园门票	昆明滇池海埂公园一日
酒泉钟鼓楼商圈酒店	酒泉钟鼓楼商圈附近的酒店
青海骑行	青海旅游自驾游
济宁孔子国际学校	济宁育才中学
杭州烂苹果	烂苹果乐园
苏州周边游一日苏州出发杭州	苏州一日游杭州出发
上海蓝波万时尚精品酒店	上海蓝波万时尚精品酒店同济路
苏州科技城	苏州科技城酒店
三亚旅游必玩	三亚好玩的
遵义的门票	遵义的景点
武汉租房子公寓	武汉租房两室一厅
西双版纳湄公河游船	湄公河西双版纳
石台溪苑	石台溪苑民宿
流量包澳门 联通	流量联通澳门
西安古城墙门票三人自行车	西安古城墙门票观光车
河南省新乡市辉县郭亮村景区	辉县郭亮村门票
重庆若夏酒店	重庆若夏商务酒店
梵净山亚木沟	梵净山亚木沟两日游
成都包车一日游	成都一日包车游
装订圈	装订
贵州六盘水胜境温泉	六盘水胜景温泉
九寨沟风景区附近的酒店	九寨沟住宿
三亚吉阳区金槟榔酒店	三亚金槟榔酒店
拉萨五年一班	五年一班拉萨
奥克兰 天空塔 	奥克兰天空塔餐厅
春秋旅行成都	春秋旅游成都
住芙蓉镇	芙蓉镇内酒店
丹东度假村	别墅丹东
长沙火车站民航大酒店	长沙火车站民航大酒店附近宾馆
较场尾民宿独栋	较场尾民宿
哈尔滨豪华家庭旅馆	哈尔滨家庭旅馆
郓城水浒	郓城水浒好汉城
宁波国际会展中心	宁波会展中心
酷航行李票	托运酷航
大理白族自治州双廊古镇	大理双廊古镇
周园	周园景区
过年台湾自由行	春节台湾自由行
优悠公寓	优 悠 公寓
三亚蜈支洲岛进阶潜水票	三亚蜈支洲岛潜水票
漓江漂流 返回	漓江漂流
古水北镇雁门客栈	古北水镇景区内酒店
上海市虹口区北苏州路	上海市虹口区东体育会路390号
 太空舱	太空舱酒店
诸暨荣怀学校附近酒店	诸暨海亮学校
云南大理下山口温泉	大理下山口温泉酒店
全季酒店广州天河	全季广州天河北酒店
联通流量中国大陆	联通流量中国
覆卮山风景区	覆卮山
惠阳汽车站	惠阳高级中学
西安七天连锁酒店大雁塔博物馆	西安7天酒店大雁塔历史博物馆
天津站休息	天津休息
百事快捷	百世快递
厦门小别墅	厦门的别墅
香港  维多利亚船票	香港维多利亚游船
重庆机酒自由行	重庆机加酒
阿里乡民宿	阿里阿里民宿
西安中建馨乐庭	馨乐庭西安
安吉寻舍民宿	安吉晓舍民宿
南宁 衡阳路中	南宁衡阳路
从化温泉 	從化溫泉
晋中榆次五中酒店	晋中榆次一中酒店
洛克岛一日游 普吉	洛克岛
广州美林湖附近的酒店	广州美林湖畔
大理包车沙溪古镇	大理包车沙溪
南京天丰一千大酒店	南京天丰大酒店
随心飞东方航空	东方航空周末随心飞
户外意外险	旅游意外险国内
涟水到上海	涟水到上海的车票
岳阳南湖大道附近的酒店	岳阳高铁站附近的酒店
松阳飞茑集民宿	松阳飞茑集
桂林龙胜龙脊梯田风雅山居客栈	桂林龙胜龙脊梯田酒店
菲律宾自由行郑州	菲律宾自由行
北京稻香湖	北京稻香湖酒店
成都天府通公交地铁异形卡	成都天府通公交地铁卡
铜仁站附近的酒店	铜仁火车站附近的酒店
台湾跟团半自由	台湾跟团游半自助
漓江船票套票	漓江船票
普吉到曼谷机票	普吉岛到曼谷机票
百色两日游	广西百色2日游
西宁包车价	西宁包车
戴森酒店(西安大雁塔南广场店) 	西安戴森酒店 大雁塔店
长隆海洋王国海底夜宿套票	长隆海洋王国2日门票
汉庭 金佰	金桥汉庭
成都市春熙路地铁站酒店	成都市春熙路酒店
广州日航大酒店	广州日航酒店
泉州八仙过海门票	泉州八仙过海
航州	航州的高铁站
酒+景	酒 + 景
福建漳州六鳌翡翠湾	漳州翡翠湾
青海湖青年旅馆	青海湖青年旅社
世佳	世佳酒店
长春红旗街	长春 红旗街
海南三亚五号别墅	海南三亚5号度假别墅
太原省人民医院	太原中心医院
运城市中心酒店	运城市中心商圈附近的酒店
湖南张家界景区	张家界热门景点
日照蓝海酒店	日照蓝海国际大酒店
逸景酒店	逸 景 酒店
深圳市福田区海滨广场	深圳 福田区
野柳 九分 	九份拼车一日游
听花堂海景花园客栈大理洱海	大理听花堂海景花园大理洱海
威海鸡鸣岛酒店	威海鸡鸣岛
曼谷白大皇宫	大皇宫曼谷
28°悦舍酒店	28°悦舍
凯宾斯基 长沙	长沙 凯宾斯基
运城市中心酒店	运城市运城酒店
铜仁市第六中学	铜仁市第五中学
澳门水舞间 住宿套票	澳门酒店水舞间套票
胡氏民居	胡氏古民居
上海野生动物园地图	上海野生动物园
海参崴签证	海参崴自由行
北京如家酒店家庭	北京如家酒店
广州到贵阳高铁	广州至贵阳高铁
效场尾	较场尾
襄阳湖北文理学院理工学院	襄阳湖北文理学院酒店
塘沽亲子房	塘沽 亲子 房
青岛崂山区东海东路	青岛崂山区海尔路附近的酒店
3月青海	3 月 青海
张家港保税区智选假日酒店	张家港假日
台州万枫酒店	台州万枫
福州恒盛精品酒店（火车站北广场店）	福州恒盛酒店
成都青羊区万达附近酒店民宿	成都青羊区新城市广场附近民宿
普宁流沙金悦莱宾馆	普宁金悦莱宾馆
大理洱海大游船船票下关	大理洱海大船游
常州中华恐龙园尚景酒店	常州环球恐龙城景尚酒店
亲子游 成都	成都亲子游
惠州万科双月湾海景	惠州万科双月湾海景房
如家快捷酒店北京苏州桥店	北京苏州桥如家酒店
珠海长隆两天一夜鲸鲨	珠海长隆二日一
哈尔滨接送机场	哈尔滨机场接送机
广州羊城通卡	广州羊城通公交卡
黄山恋上民宿	黄山的民宿
春天宾馆，中央大街三店	春天商务宾馆哈尔滨中央大街店
大鹏可域酒店	大鹏佳兆业可域精选酒店
美在旅途	咸阳爱在旅途商务宾馆
老北京	老 北京
合肥高速玛丽蒂姆	合肥安徽高速玛丽蒂姆酒店
斯堪的纳度假酒店	斯堪的纳酒店
九寨沟两日游	九寨沟2日游
曼谷曼谷芭提雅	曼谷 曼谷 芭 提 雅
桃花潭镇	桃花潭附近的酒店
厦门青年旅馆	厦门中山路青年旅社
江西武宁景点	武宁旅游景点
跟拍 大理	大理旅拍一日游跟拍双人
十二间房	二十间房
长沙巴厘岛机	长沙巴厘岛
阳光海岸酒店	阳光海岸
如家商旅酒店 杭州西湖黄龙	如家杭州西湖黄龙
丹东中联	丹东中联大酒店
长白山紫玉酒店	长白山紫玉度假酒店
成度儿童剧场	儿童剧场
上海崇明岛南门酒店	崇明岛南门附近的酒店
香格里拉游玩	香格里拉2日游纯玩
临时上海公交地铁卡	上海公交卡定制
泰来	泰来国际
杭州大型野生动物园	杭州野生动物园
龙脊梯田漂流	桂林龙脊梯田漂流
西安出发北京四日三晚游	西安出发北京纯玩四日三晚游
大东方小东方	大东方
杭州西溪喜来登度假酒店国际会议中心	杭州西溪湿地喜来登度假酒店
乌镇内	乌镇西栅内
梦景彩虹艺术酒店(昆明火车站店)	梦景彩虹艺术酒店（昆明火车站环城南路地铁站店）
香港旺角酒店	香港旺角油麻地酒店
长沙中建五局酒店	长沙湖南中建五局附近的酒店
龙港瑞都	龙港瑞都商旅酒店
南通周边游一日	南通当地玩乐1日游
成都宽窄巷子攻略	成都攻略市区
重庆富丽假日酒店	重庆富力假日酒店
月亮湾碧海蓝天度假邨	月亮湾碧海蓝天度假酒店
长沙五一广场地区附近的锦江	长沙五一广场地区麻将
泊捷e	泊捷e酒店
绍兴联票13景点	绍兴联票13一日
西安咸阳国际机场空港商务酒店	西安咸阳国际机场空港大酒店
普吉岛   门票	普吉人妖门票
九龙溪	九龙溪生态公园
铜仁到福州	福州到铜仁
银杏湖乐园接送	南京银杏湖乐园
昆明到浙江	昆明到杭州
保山龙陵邦腊掌温泉门票	保山龙陵邦腊掌温泉
乐宁波凤凰山	宁波凤凰山
塞班蓝洞潜水	塞班蓝洞体验潜
大理水舍沐语全智能客栈	大理水舍沐语客栈
河北省北戴河疗养院	北戴河工人疗养院
松花江路	松花江南路
沈阳办泰国签证	沈阳泰国签证
兴安乐满地大门票	兴安乐满地门票
夏威夷火山	夏威夷 火山
上海迪士尼婚礼	上海迪士尼度假区婚礼
珠海情侣路酒店如家	珠海如家酒店
杭州市上城区	杭州市下城区
新加坡动物园门票实体	新加坡动物园门票
重庆天地人和街小学	重庆儿童医院附近酒店
六盘山森林公园车票	六盘山森林公园
浦江元温泉	浦江温泉
宜春明月山天沐温泉门票	江西宜春明月山天沐温泉门票
三亚游艇出海一日游海棠湾	三亚一日游游艇出海
惠州双月湾私人海滩	惠州双月湾海景房泳池
雅鲁藏布江大峡谷一日游	雅鲁藏布大峡谷一日游
江西湖南自驾游	江西自驾游
开臣璞尚酒店	开臣璞尚
三亚保利别墅	三亚保利海棠湾别墅
普及岛跟拍	普吉岛写真
巴厘岛自由行包车	巴厘岛包车
广州北京游	广州北京跟团
呼伦贝尔大草原骑马纯玩	呼伦贝尔大草原骑马
宁夏 自由行	宁夏3日游
怎样购买托运行李	怎么样购买行李托运额度
三亚亚龙湾儿童浮潜	三亚亚龙湾一日游潜水
上海迪斯尼乐园亲子门票 1日半	上海迪斯尼乐园半日门票
上海环球金融中心观光厅门票	上海环球金融中心的门票
额济纳跟团	额济纳
gopro出租	gopro租
北京朝阳区外国专家大厦酒店	北京外国专家酒店
杭州江干区钱江新城洲际酒店	杭州钱江新城洲际酒店
迪士尼上海bip	迪士尼上海vip
临江上品酒店公寓	临江上品公寓
温泉跟团广州出发	广州出发跟团温泉两日游
济南桔子酒店泉城广场店	济南桔子酒店精选泉城广场店
海洋公园夜场	海洋公园 双人票
加.芭提雅阁精品公寓广州奥园店	广州芭提雅阁精品公寓
青岛西海岸新区民宿	青岛海信广场民宿
武汉市江岸区解放公园路	武汉江岸区江汉北路附近的酒店
杭州景域酒店	杭州景域庭园酒店
重庆礼嘉中学	重庆第十一中学
长白山橘子	长白山桔子
日本奈良和服	日本 奈良 和服
雁荡山三日游	雁荡山三日游跟团
南宁滑草场	南宁滑草
巧克力王国希尔顿	巧克力王国希尔顿酒店
海口捕鱼	海口钓鱼
吴川喜来登	吴川福朋喜来登酒店
广州中医药大学附属第三医院	广州中医药大学第三附属医院
济南历下区历山路	济南市历下区文化东路
九寨沟云孚里	云孚里酒店 九寨沟
长沙到滕州	滕州到长沙
石家庄广播电视台附近的酒店	石家庄技师学院附近的酒店
重庆梵调美宿	重庆梵调美宿江景美宿(洪崖洞店)
上海 大同	大同上海
深圳宝安区丽枫酒店	深圳 南山区 丽枫酒店 
富春芳外	富春山居芳外
合肥的酒店瑶海区	合肥海洋世界附近的酒店
淮安市淮阴区酒店	江苏淮安市淮阴区
常州环球恐龙城维景	常州中华恐龙园门票加酒店维景
东海湾大酒店	东海湾假日酒店
呼市火车东站	呼市火车东站酒店
湖州龙王山漂流酒店	湖州安吉-龙王山漂流酒店
乌鲁木齐市乌鲁木齐高铁站酒店	乌鲁木齐火车站地铁附近酒店
海友 	海友酒店 
云南大理丽江5天4晚情侣直飞	云南大理丽江五日四晚双飞纯玩
亚龙湾喜来登下午茶	亚龙湾万豪下午茶
潮州懒猫客栈（牌坊街店）	懒猫客栈潮州
兰州99优选酒店	兰州99优选酒店(文化宫店)
曹妃甸住宿	曹妃甸东站
倪氏海泰大酒店青岛	青岛倪氏海泰大酒店
千禧酒店	千禧国际
海口世纪公园酒店	海口世纪公园
福州的酒店万豪	福州万豪酒店
环球影城乐园酒店	环球影城 酒店
日不落杭州	杭州日不落
保定市保定东站酒店	保定市保定职业技术学院酒店
万豪自助餐首座	万豪首座自助
上海又见·美宿（旗舰店）	上海又见美宿旗舰店
厦门52赫	厦门52
南京南站美居酒店酒店套餐	南京奥体博览中心美居酒店
常州的汉庭酒店	汉庭常州
广州欣荣宏·国际商贸城酒店	广州欣荣宏酒店
三天两晚广州出发	广州出发三天游
太原南站到太原站	太原南到太原站
古镇到广州南的火车票	古镇到广州南
云台山夜景	云台山夜游
樱桃园	樱桃 园
辰悦酒店	辰悦
懒猫旅行仙本那一日游专送	懒猫旅行仙本那一日
天台景区	天台一日
哈儿滨极地馆	哈尔滨极地馆
莫干山山野民宿	莫干山山野
漳州市漳州职业技术学院酒店	漳州市漳州理工职业学院酒店
澳门航空行李	澳门航空行李额购买
湖北神农架国际滑雪温泉	湖北神农架国际滑雪场温泉
敦煌可可西里	敦煌可可西里七日
武夷山周边亲子游	武夷山周边游
十渡拒马河乐园套票	十渡拒马河乐园门票
湖南特色美食	湖南美食
广州民宿广州塔	广州塔附近民宿
韩国签证成都送签	韩国签证个人成都
三亚亚特兰蒂斯康年	三亚亚特兰蒂斯康年酒店
张家界京武铂尔曼酒店酒店套餐	张家界京武铂尔曼酒店
报团贵州	跟团贵州
成都工业职业技术学院天府新区	成都职业技术学院高新校区
三亚亚龙湾迎宾	三亚迎宾
重庆市渝中区长江二路	重庆市江北区
成都飞贝加尔湖	成都贝加尔湖
花鸟岛两天	花鸟岛二日游
黄山的全季酒店	黄山全季酒店
宁波市镇海区十七房	宁波十三房
安吉自由行三天两晚	安吉3天2晚
海陵岛保利海上时光	阳江海陵岛保利海上时光
九寨沟精品	九寨沟县城
世奥	世奥酒店
武汉国博中心北附近的酒店	武汉市园博园北(地铁站)酒店
东营的酒店	东营酒店
巴厘岛机场附近酒店	巴厘岛机场
敦煌莫高窟一日游西	西宁四日敦煌莫高窟
上海迪士尼一日	上海 迪士尼 一 日
苏州艺术馆	苏州美术馆
亚龙湾 项目	亚龙湾水
常州武进区横山桥镇附近的酒店	江苏常州市武进区酒店
希尔顿花园酒店成都	希尔顿成都
乐客城	乐客 城
平潭岛景点	平潭岛旅游景点
清远旅游景点跟团一日游	清远一日游纯玩
恩施大峡谷一日纯玩游	恩施大峡谷1日游
杭州西湖玉古路亚朵s吴酒店	杭州西湖亚朵
新疆旅游包车南北疆环线跟团	新疆旅游包车私人订制南北疆
天津宁河酒店	天津宁河宾馆
小民城市民宿	城市民宿
山姆会员超市	山姆会员
毕棚沟达古冰川温泉	毕棚沟达古冰川滑雪温泉
u型热水袋	热水袋
眉山印象诗书	眉山印象诗书酒店
扬州维景	扬州维景酒店
四姑娘山5日游	四姑娘山5日
黄果树佳源酒店	黄果树合源酒店
哈尔滨万达乐园	哈尔滨万达游乐场
蓝朵	蓝朵精品酒店
杭州MAX电竞酒店	杭州电竞酒店 三人房
南京 温泉	南京汤山
珠海荷包岛往返船票一日游	珠海荷包岛往返船票
郑州尚客优品	郑州尚客优
台湾怎么签	台湾旅游入台证
深圳机场租车	深圳市租车
海南三亚旅游5天4晚自由行/开平	温州海南三亚旅游五日自由行
雅加达的当地玩乐	雅加达一日游
修武西站	修武西站附近的酒店
乐山万达附近酒店	乐山万达广场
南昆山富力养生谷欧式温泉别墅	富力南昆山温泉养生谷别墅
成都到西安	西安至成都
铜仁德江县	铜仁市德江县
济南山东省济钢高级中学	山东省济南第二中学
上海自然博物馆电影票	上海自然博物馆讲解票
深圳京基	深圳京基京寓酒店
港澳台通行证签注	港澳通行证注签
若尔盖五日游	若尔盖5日
杭州钱塘江观潮点	杭州钱塘江观潮大潮
尚美宾馆	尚美优精选酒店
欧尔堡水上世界	欧乐堡水上世界
西宁一日半	西宁一日游接送
泸州商贸城柚子酒店	泸州柚子
广州长隆熊猫酒店 自助餐	广州长隆熊猫酒店自助餐
陇南市一中	陇南市实验小学
平阴汽车站	平阴宾馆
成都缘雅居	成都雅居
美居 武汉	武汉美居
城市快捷酒店武汉龙阳	武汉城市快捷酒店
崇明郊野公园	崇明森林公园
亚特兰地斯水族馆	亚特兰提斯水族馆
深圳壹方城购物中心	深圳壹方城附近的酒店
曹妃甸大学城住宿	曹妃甸大学城
四川到深圳	成都到深圳
桂林清风实验学校	桂林师范高等专科学校酒店
海口海口美兰国际机场酒店	海南海口美兰机场附近酒店
陕西省丹凤县的酒店	陕西省丹凤县
成都购物商场	成都优品道广场酒店
连城县山水田园民宿	连城县民宿
武汉出发庐山	武汉到庐山
高端酒店	高端
雅安周公山温泉票	雅安周公山温泉
林芝进拉萨出	拉萨到林芝拼车
昆明七彩云南欢乐世界门票当日	昆明七彩云南欢乐世界夜场票
park plaza westmister	park plaza westminster
清远英德宝墩湖湖山温泉度	清远宝墩湖湖山温泉度假村
富阳宾馆	杭州富阳宾馆
海南三亚旅游5天4晚包车	三亚5天包车
西双版纳 中科院	西双版纳植物园
咸宁万豪温泉酒店	咸宁万豪酒店
阳朔定制游	阳朔当地团
万州区	万州区政府
西双版纳热带植物园酒店	西双版纳中科院植物园酒店
珠海东澳岛/格力东澳度假区酒店	珠海东澳岛格力东澳大酒店专营
北京妙峰山景区	北京妙峰山
宿天驿农庄	天驿农庄
全季苏州观前街酒店	苏州全季酒店观前街
滑雪富龙	富龙滑雪
星愿精品酒店式豪华公寓	合肥星愿酒店式公寓
北京国家开放大学社会考试基地酒店	北京开放大学社会考试基地
泰安市泰山风景名胜区酒店	泰安泰山附近的酒店
上海迪士尼国庆一日门票	上海迪士尼门票一日
三亚别墅民宿	三亚民宿别墅
三亚酒店套餐君悦	三亚海棠湾君悦
苏州游乐园门票	苏州游乐场
接送机服务昆明	昆明接送机
英国冰岛	英国 冰岛
港澳 电话卡	港澳4g手机卡
四姑娘山三天两晚	四姑娘山3日
东莞麻将酒店	东莞酒店麻将房
无锡亲子酒店融创	无锡融创亲子酒店
苏梅岛红帆船一日游	苏梅岛一日帆船
溉阳湖欢乐世界	暨阳湖欢乐世界
张家界依山客栈	张家界依山归舍客栈（森林公园店）
三亚酒店卷	三亚酒店券
辽阳西路	辽阳东路
汾阳市林通快捷酒店	汾阳市龙都快捷酒店
北京的公寓	北京公寓酒店
婺源	婺源风景区
西塘静悦庭庭院	西塘静悦庭
上海咸宁路附近的酒店	上海咸宁路地铁站
郑州方特欢乐世界家庭套票	郑州方特欢乐世界门票下午票
广州大佛寺	广州大佛古寺
辽宁省交通高等专科学校酒店	辽宁省交通高等专科学校
沈阳市沈阳农业大学酒店	沈阳大学附近
紫荆商务酒店济南钟点房	济南紫荆商务酒店
西安康复路 西北商贸城	西安儿童医院
沛县的酒店	沛县酒店
博鳌别墅	博鳌 别墅
澳门丽兹卡尔顿	丽思卡尔顿澳门
郴州市中心	郴州市
大柴旦泡温泉	大柴旦温泉
厦门出发游轮	国内豪华邮轮旅游厦门出发
阳泉至石家庄正定机场	正定机场石家庄
伊犁7日	伊犁7日游
香港迪士尼优先证	香港迪士尼优先
虎跳峡两日游	虎跳峡徒步两日游
豪泽丽	沈阳豪泽丽兹酒店
怀化学院(东校区)	怀化学院东校区
成都市武侯祠酒店	成都 武侯祠 酒店
桂林两江四湖夜游雙人	桂林两江四湖夜游
兴国到宁都	宁都到兴国
东戴河银泰房车酒店	东戴河银泰房车
摩洛哥wifi租赁机场	摩洛哥机场wifi
广州北到广州东	广州到广州南
流量包欧洲	欧洲流量包
汉中留坝楼房沟民宿	汉中楼房沟民宿
?象山影视城	象山影视
白虎餐厅 午餐	白虎餐厅
江西省周边游	江西 省 周边 游
今日广州塔e区	广州塔今日
长寿古镇	重庆长寿古镇
千岛湖亲子度假	千岛湖亲子
成都东站到重庆沙坪坝高铁	重庆西站到成都东站火车票
贵都酒店	贵都商务酒店
长白山天池跟团	长白山天池旅游攻略
三亚湾红树林度假世界（棕榈王国酒店）	三亚 红树林 棕榈王国
芭堤雅全身spa	芭堤雅spa
上海大宁国际商业区酒店	上海大宁国际商业区附近的酒店
威海希尔维亚	威海希尔维亚酒店
肇庆岩前村酒店	肇庆 岩 前 村 酒店
宁波罗蒙环球乐园主题酒店亲子	宁波罗蒙环球酒店亲子
绵阳师范	绵阳师范学院高新校区
外滩东方商旅	外滩东方商旅酒店
宁波方特东方神画周边名宿	宁波方特民宿
牡丹江市第五高级中学	牡丹江市第二高级中学
滑雪攻略	滑雪场攻略
北海北渡假酒店	北海北度假酒店
桔子酒店北京丽泽	桔子北京丽泽
珠海长隆海洋王国企鹅酒店套票家庭房	珠海长隆海洋王国企鹅酒店套票亲子
临夏到定西	定西到临夏
廊坊新朝阳套房假日酒店	廊坊新朝阳假日酒店
太原骀台山门票	太原台骀山门票
三亚3日游	三亚三日游
三亚康年酒店标间	三亚酒店康年
滑雪 云上	滑雪云上
美娜多 网卡	美娜多网
长沙维也纳五一广场	长沙的维也纳酒店
霍山 自由行	漂流霍山
三亚悦家	三亚亚龙湾悦家度假公寓
武汉光谷情趣酒店	sm情趣酒店武汉
承德避暑山庄附近酒店	承德住宿
苏州西山岛留恋往返精品民宿	苏州留恋往返精品民宿
纯泰拳比赛	泰拳比赛
骏怡连锁酒店合肥淮河路步行街店	骏怡连锁酒店合肥庐阳淮河路
雅安团	雅安跟团
云南旅游无购物	云南纯玩无购物
巴厘岛秋千和梯田	巴厘岛秋千梯田
无锡三国城水浒城游船联票	无锡三国城水浒城联票门票
长白山1日游	长白山一日团
山叶口景区通票	山叶口通票
山东省教育厅	山东省招生考试院
南宁万象城酒店	南宁万象城地铁站
衡阳南岳衡山附近的酒店	衡阳南岳衡山酒店
重庆 旅拍	重庆拍
重庆欢乐玛雅水上	重庆玛雅水上
西安西二环路附近的酒店	西安北二环附近酒店
深圳长租房	深圳短租房
泰式spa	泰国清迈按摩
海南一卡通	海南旅游一卡通
wi-fi漫游超人	wifi漫游超人
广州长隆自助	广州长隆自助餐
成都动物园景区	动物园成都
温州 楠溪江	温州楠溪江
奥园广场酒店	奥园城市广场
郑州市第十九中学	郑州市第三十一中学
黔东南肇兴侗寨酒店侗赏	黔东南肇兴侗寨
那金谷套票	那金谷门票
北京五日	北京五天四晚
杭州杭行路希尔顿欢朋酒店	希尔顿欢朋杭州
青岛市青岛机场酒店	青岛机场 住宿
福州速8酒店中洋	速8酒店福州福新中路店
枪。	射击
芜湖广济医院	芜湖高级职业技术学校
沙巴美红树林一日游	沙巴一日红树林
王顶堤	王顶堤附近酒店
重庆涪陵北站	重庆涪陵北酒店
如家酒店天津空港	如家商旅(金标)-天津空港中心大道行政中心店
厦门灵玲大酒店主题酒店	厦门灵玲大酒店
南京市溧水区	南京溧水区酒店
川师大地铁站	川师大
太古里一记忆空间	太古里记忆空间
洲际酒店平和	平和洲际
潮州市潮安区酒店	潮州市潮安区
香港龙华宾馆家庭宾馆	香港龙华
美林湖酒店	美林湖
天门山索道票	天门山景区门票
龙岩龙硿洞风景区	龙岩龙硿洞
如家新街口地铁站	如家酒店新街口
涂图旅行	旅行图
上海徐家汇肇嘉浜路酒店	上海徐家汇地铁站附近酒店
半自由日本浅	半自由日本
梵净山一日游纯玩贵阳	梵净山一日游贵阳
巽寮湾高层海景两房一厅	巽寮湾2房
杭州的旅游景点	杭州的景点
济南汽车站附近酒店	济南长途汽车站附近的酒店
首尔南怡岛一日游	南怡岛小法兰西一日游
电子科技大学中山学院附近酒店	电子科技大学中山学院酒店
楚雄酒店	云南楚雄酒店
二郎山喇叭河索道	二郎山喇叭河
西安到枣庄	枣庄到西安
北戴河一日游唐山	北戴河一日
福州省立医院酒店	福州省立医院
行李箱18	行李箱28
特罗姆瑟 	特隆姆瑟
贵阳到重庆西的火车票	重庆西到贵阳东的动车
攀岩 杭州	攀岩杭州室内
西双版纳长租房	西双版纳短租房
济州岛新罗舒	济州岛新罗
包车浙江	浙江 包车
罗浮山滑翔	罗浮山
南昌度假	南昌度假酒店
黄山北站接站	黄山高铁站接送
海棠湾三亚国际免税店	海南三亚海棠湾免税店
迪士尼花车巡游	迪士尼 花车
姑咱镇的宾馆	姑咱镇
金椰岛	金 椰岛
安徽财经大学附近的酒店	安徽中医药大学
漳州云顶温泉门票套票	漳州云顶温泉一日套票
九江市高级技工学校	九江市双语实验学校
青岛栈桥海景酒店	青岛的海景酒店
香港迪斯尼快速票	香港迪斯尼餐券
海南省妇幼保健院	海南省人民医院
太原机场租车	太原租车
广州W酒店自助餐	广州星级酒店自助餐
霍山陡沙河温泉小镇门票	霍山陡沙河温泉小镇一日
长白山滑雪助理	长白山滑雪教练
毕棚沟鹧鸪山滑雪	毕棚沟鹧鸪山滑雪2日游
石岐路易酒店	中山路易酒店
艾美 石梅湾	石梅湾艾美酒店
阳江包车	阳江海陵岛包车
武汉地铁线路图	武汉地铁2号线线路图
合肥的青年旅舍	合肥青旅
伶仃岛船票	外伶仃船票
重庆名钻	重庆名钻酒店 解放碑店
广州远景路	广州远景路酒店
镇江火车站附近酒店钟点	镇江火车站酒店
万宁思想家度假公寓	万宁私享家度假公寓
青岛 全季酒店	青岛的全季酒店
千岛湖中心湖景区	杭州千岛湖中心湖景区
凯旋龙酒店(长沙车站店)	凯旋龙连锁酒店长沙火车站店
上海送签日本	日本签证 上海
舟山朱家尖乌石塘海景酒店	舟山市小乌石塘酒店
深圳龙岗区民宿	深圳龙岗民宿
郑州h酒店	H酒店·郑州航海路店
广州长隆野生动物园门票长者票	广州长隆野生动物园门票电子票
曼谷 亲子游	曼谷一日游动物园
中南大学附近的酒店	中南大学南校区
石狮附近旅游景点	石狮景点
英德奥园希尔顿	英德奥园希尔顿逸林酒店
德威航空行李d	德威航空
上海紫竹酒店	上海紫竹
上海江景房酒店	上海外滩江景房酒店
签证机票赔偿	签证机票
丽江福临客	丽江福临客栈
红树林希尔顿逸林酒店	红树林希尔顿欢朋
厦门同安方特特色房	厦门同安方特梦幻王国
深圳野生动物园门票特惠	深圳野生动物园套票
广州优优公寓	广州优优公寓式酒店(正佳东方店)
长隆熊猫酒店晚餐	长隆熊猫酒店自助
万宁冲浪板	万宁 冲浪
兰州周边游	兰州周边游三日
天津三天	天津自由行3天
达州市高级中学	达州市中心医院住院部附近酒店
尼嘞克	尼勒克
桔子精选北京天宁寺酒店	桔子酒店北京天宁寺店
成都青城山民宿	成都青城山名宿
red	Red
大阳湖	大 阳湖
汉中维也纳酒店	维也纳酒店(汉中高铁站店)
韩国签证团签青岛	青岛送签韩国签证
阳朔桂林游船	阳朔到桂林游船
潮州跟团珠海长隆海洋王国	跟团珠海长隆海洋王国
查看全部共7张上海乐居精品主题公寓国家会展中心虹桥店	上海乐居精品主题公寓国家会展中心虹桥店
洛阳 博物馆	洛阳博物馆门票
上海迪斯尼官方店	上海迪斯尼官方
福州平潭海边民宿	福州平潭望海民宿
武汉亚朵酒店洪山区	武汉亚朵酒店 
换洱海	环洱海
四川5天4夜跟团	四川5日纯玩游
室内私人温泉福州	私人温泉福州
南靡岛	南麂岛
西措康桑国际青年旅舍	西措国际青年旅舍
新疆旅游卡通门票	新疆一卡通
世纪金源大饭店长沙	长沙世纪金源大饭店
长春到长白山包车	长白山长春包车
宿务机场码头	宿务市区接送机
三亚帆板	三亚 帆板
武汉 万达	武汉的万达酒店
武义一水间	武义一水间民宿
五台山普化寺附近住宿	五台山殊像寺附近的酒店
屿海民宿	海屿民宿
重庆名宿酒店	重庆 名宿
台儿庄美食	台儿庄自助餐
亨来斯登	亨來斯登
大连海创酒店	大连海事大学海创酒店
襄阳旅游卡	旅游襄阳
杭州西湖酒店民宿	杭州西湖名宿
成都春熙路民宿可做饭	成都名宿可以做饭
茅山涵田度假村半山温泉	茅山涵田度假村
锦江都城廊坊万达广场酒店	廊坊锦江都城
昆明清明曼谷	昆明曼谷
尼泊尔电子签证	尼泊尔半年签证
陈巴尔虎旗牧云	陈巴尔虎旗牧云山顶酒店
黄山 排云楼	黄山排云楼宾馆
天津时代奥城	天津时代奥城附近的酒店
洛杉矶当地拉斯维加斯游	洛杉矶 当地 拉斯维加斯 游
杭州鼎御商务酒店西湖店	杭州鼎御商务酒店
步萨拉清迈	清迈萨拉
夏驿	夏驿酒店
恒山国际酒店	恒山国际
广州长隆三园	广州长隆四园
三人游电竞	电竞单人
廊坊阿尔卡迪亚	阿尔卡迪亚廊坊
深圳别墅出租	深圳的别墅
甘肃电大	甘肃农业大学附近宾馆
香港一日过境卡	香港交通卡一日通
苏梅岛 泰式写真	苏梅岛写真
广州到樟木头	广州东到樟木头
肥东第一中学	肥东汽车站
武功山金顶四人帐篷	武功山金顶星空帐篷
新加坡民丹岛机票加酒店	新加坡民丹岛机票酒店
四川七日	四川7天6晚
泽栖	泽栖酒店
五人电竞	五人电竞酒店
珠海长隆企鹅2天1晚	珠海长隆企鹅酒店2天1夜
橘子酒店济南泉城广场店	济南橘子精品酒店
新加坡无边泳池门票	新加坡无边界泳池
广西南宁外国语学校	南宁广西职业师范学校酒店
斐济接送机	斐济用车
西安到贵阳的高铁	西安到贵阳
延边跟团	延边三日游
华亭到西安	西安到华亭
机场vip贵宾休息室三亚	三亚机场vip休息室
丽江花辰月夕客栈	丽江花晨月夕客栈
烟台至大连的轮渡 几点发船	烟台轮渡至大连
行走平遥	行走平遥客栈
保定市高新区小学	保定市美术中学
芭提雅SAP	芭提雅精油spa
厦门到柳州	柳州到厦门
成都春熙路民宿三床房	成都春熙路附近酒店民宿套二
宜昌东到武昌的火车票	武昌至宜昌火车票
永州到贵阳	贵阳到永州
n.hotel	n.hotel酒店
广东海洋大学寸金学院新湖校区	广东海洋大学寸金学院
贵阳依山壹舍	贵阳云舍村酒店
西岛珊瑚礁潜水	西岛深潜
苏苏州狮子林门票	苏州拙政园狮子林门票
金沙旗艦店	金沙酒店旗艦店
三亚  跟拍	三亚个人写真拍照
海南三亚湾国光豪生	海南 三亚 湾 国光 豪 生
海口市希尔顿	海口希尔顿欢朋
昌黎时代海岸一线海景公寓酒店	昌黎时代海岸观海公寓
国泰航空行李额度	国航行李额度
三亚租车兜风	三亚租車
上海中兴路(地铁站)酒店	上海东宝兴路地铁站酒店
雪山一日游	雪山一日
辽宁周边	辽宁两日游
中洲万豪自助餐	中洲万豪自助
中华广场	中华广场酒店
陆家嘴金融服务广场	陆家嘴金融广场
长白山天池北京出发	去长白山天池
杭州西湖西子酒店	杭州西子
上海迪士尼民宿网红	上海迪士尼网红民宿
杭州市下城区长浜路新天地	杭州市滨江区浦沿路773号
x美术馆	X美术馆
上海最大的水上乐园	上海水上乐园
大连汤景泽温泉接送	大连汤景泽温泉
南浔镇	南浔古镇景区内住宿
洛阳凯芙特	洛阳凯芙特智能酒店
全季成都太古里中心	全季成都太古里滨江路酒店
北京天坛人工讲解	北京天坛讲解
苏州太湖民宿吊床	民宿苏州太湖
西安到乌鲁木齐	乌鲁木齐到西安
白塔机场/呼和浩特火车东站商圈	呼和浩特白塔国际机场
太原7天酒店	太原七天
荷兰	荷兰旅行
羊湖 一日游	羊湖纯玩一日游
日本电话 通话	日本电话卡通话
昆明壹途旅行社	昆明欢途旅行社
昆明橘子水晶酒店	桔子水晶昆明东风广场酒店
野鸭湖附近的酒店	野鸭湖酒店
南京南大有园	南京大学有园
杭州滨江天街	杭州滨江区酒店
兰州蓝莓精品酒店定西路店	兰州蓝莓精品酒店
汉庭酒店无锡太湖风景区店	汉庭酒店无锡太湖一日店
仙本那跳岛游  骆驼	仙本那跳岛游
长春市桂林路酒店	长春桂林路附近
上海站出发迪士尼一日游	上海迪士尼一日苏州
嵊泗本岛酒店	舟山市嵊泗县-嵊泗本岛酒店
大兴医院	北京大兴医院
苏州吴江松陵饭店酒店	吴江松陵饭店
张扬丹霞地貌	张掖丹霞地貌
博物馆广东	广东博物馆
速8酒店（淮南国庆路万达店）	淮南速8酒店
撒哈拉何兮	何兮撒哈拉
汝州温泉镇	河南汝州温泉
杭州西湖风景区家庭房	杭州西湖家庭房
上海迪士尼乐园酒店 汉庭	上海汉庭酒店迪士尼
宁波方特东方神画车	方特东方神画宁波
鼓浪屿轮渡船票 钢琴码头	鼓浪屿轮渡船票轮渡码头
鉴证泰国	泰国签
杭州景区套票	杭州景点门票
崂山君澜度假	崂山君澜
丽江古城附近景点	丽江古城的门票
南昆山云顶温泉酒店	南昆山云顶温泉度假旅游酒店
因特拉肯滑翔伞	因特拉肯 滑翔伞
三峡游轮凯悦号	三峡游轮黄金邮轮
诺美誉博	诺博美誉酒店
萍乡步行街酒店	萍乡北附近酒店
合肥铁路工程学院	合肥经济技术职业学院
普吉接送机	普吉送机
北海自助游	北海自由行旅游攻略
岳阳2599酒店公寓优惠券	岳阳2599酒店公寓
上海 厦门	上海到厦门
太原市小店区体育西路酒店	太原小店区实验小学附近的酒店
兰州市区一日游	兰州的当地玩乐一日
西宁租车自驾	西宁自驾
蚌埠高铁站附近酒店	蚌埠南站附近的酒店
银川的门票	银川市里的景点
三亚千古情附近民宿	三亚 民宿
威海独栋民宿	威海民宿
广州百顺宾馆区庄店	广州百顺宾馆环市中路店
祖山攻略	祖山风景区学生票
上海迪士尼乐拍通套票	迪士尼门票乐拍通
台州市台州椒江区市府大道酒店	台州市市府大道商圈酒店
泰国签证南通	泰国签证河南
宿迁电竞酒店	宿迁sog电竞宾馆
影院酒店	影院
上海外滩附近	上海外滩附近的酒店
厦门华侨大学酒店	厦门大学酒店
吉林雾凇节	吉林雾凇
通州土桥	北京通州土桥
龙游县酒店	龙游县第三中学附近酒店
太舞滑雪场	太 舞 滑雪 场
北京新桥诺	北京新桥
锦江之星长春人民大街桂林路店	锦江之星长春火车站新店
西华师大宾馆	西华师大
野三坡一日游	野三坡一日
温泉巢湖	巢湖温泉酒店
普吉蛋岛一日	普吉蛋岛
上海商城酒店公寓	上海商城酒店式公寓
桂林游船四星	桂林四星船
澳大利亚+自由行	澳大利亚8晚
江门台山那琴半岛地质公园门票	台山那琴半岛门票
张家界接机当天	张家界接送机接站 张家界旅游 荷花机场24小时接送机服务接机
新疆二日游乌鲁木齐出发	新疆两日游乌鲁木齐出发
上海嘉定安亭东方肝胆医院附近	上海嘉定安亭站
北京双飞5天4晚自由行盐城	跟团北京双飞五日自由行
成都邛崃天台山景区名宿	成都邛崃天台山景区民宿
温州半岛环城商务酒店	温州半岛酒店
内蒙古四日游	内蒙古旅游4天
全日空往返	全 日 空 往返
广州周边自驾	广州附近自驾游
萍乡到宜春	宜春到萍乡
清华长庚医院	清华大学长庚医院
港珠澳大桥门票	港珠澳大桥夜游
上海地铁宜山路站附近的酒店	上海徐汇区宜山路
厦门青年阳光连锁酒店东渡	厦门青年阳光酒店厦鼓码头店
重庆来福士探索舱	重庆来福士探索舱观景台
阿依河下段漂流	阿依河下漂
上海锦江之星酒店民生路	上海锦江之星北外滩店酒店
亳州汤王温泉	亳州汤王温泉酒店
山东理工职业技术学院	山东科技职业学院
南昌理工学院专家楼	南昌大学北区
长沙美宿欢酒店	长沙美宿欢致
纽宾凯荆州	荆州纽宾凯国际酒店
武汉江夏区	武汉汉南区酒店
城市便捷（成都春熙路店）	成都城市便捷
林dian	林甸
上海到冲绳自由行	长沙冲绳自由行
锦江之星北京万丰	锦江之星北京万丰路
白银市白银区	白银市的酒店
澜苑酒店	澜苑
郑州航空港万怡	郑州航空港万怡酒店
浙江欢乐谷世界	欢乐谷浙江
横店二日游双人	横店2日游
横冲	横冲旅游
厦门湖滨中路酒店	厦门湖滨东路酒店
香港皇家太平洋酒店尖沙咀接机	香港皇家太平洋酒店
青旅上海	上海的青旅
西安云裳精品酒店	西安云裳西唐
入台证含保险	入台证保险
新西兰团游	新西兰当地团
江浙沪农家乐	江浙农家乐
大理丽江半自由行	丽江大理自由行
泉眼温泉 酒店	中山温泉宾馆
河南拼车	河南包车游
北京龙脉温泉度假村	北京龙脉温泉度假村门票
洛阳水上乐园门票	河南省洛阳水上乐园
坝上草原城墙酒店	坝上草原酒店
白鹿仓套票	白鹿仓门票
横店秦王宫	横店秦皇宫门票
7天连锁酒店杭州萧山机场店	7天酒店萧山机场店
南天湖两日	南天湖二日游
济南齐鲁工业大学长清校区	济南山东交通学院长清校区酒店
浙江省绍兴市浦阳路	浙江绍兴
上海迪士尼附近宾馆免费接送	上海迪士尼民宿免费接送
汕头南澳岛旅游景点	汕头南澳岛攻略
百色平果	百色平果酒店
7天优品福州	7天优品酒店福州
上海唯庭酒店上海新天地	上海 唯庭轻奢
海阳水上乐园	海阳水世界
上海迪斯尼迪士尼乐园酒店门票	上海迪斯尼迪士尼乐园门票双人票
日月光中心r3民宿	日月光中心民宿
地铁卡重庆	公交卡重庆
邮轮出境游	邮轮 出境 游
香格里拉梅里雪山大门票	香格里拉梅里雪山
防城港白浪滩海景房	防城港白浪滩酒店
圌山温泉	沩山温泉山庄
大阪环球影城门票快速票哈利波特套票	大阪环球影城哈利波特快速票
潍坊临朐揽翠湖	临朐揽翠湖
新疆雪域仲	新疆雪域
海洋乐园成都	成都极地海洋门票
天域美食	天域自助晚餐
昆明私人导游	昆明导游
郑州惠济区万达	郑州二七万达
夫康杜玛	马尔代夫康杜玛岛6天4晚 酒店套餐 酒店预订 马尔代夫酒店代理
流量澳洲	流量澳大利亚
河海大学鼓楼校区	河海大学鼓楼
圣灵群岛两夜	圣灵群岛二日
昆明纯玩团	昆明团
长隆 水水世界	水世界长隆
杭州市省中医院附近的宾馆	杭州附一医附近酒店
三亚接送商务车	三亚商务车
贵阳西南商贸城酒店	贵阳西南国际商贸城附近的酒店
都江堰景区玉垒山温泉	都江堰景区玉垒山
一日游秦岭	陕西秦岭一日游
大同住宿	大同大学
毕棚沟 九寨	毕棚沟2日九寨沟
婺源自由行攻略	婺源旅游攻略
漠河圣诞滑雪场	漠河圣诞村滑雪
日本 夜 巴士	日本巴士
陆家嘴万信	上海万信酒店 陆家嘴
拉萨跟团游榆林	拉萨跟团游
跟团四川	四川游
仙本那 fundive	仙本那fun dive
珠海长隆海洋王国一日游跟团东莞	东莞-珠海长隆海洋王国、港珠澳大桥2日游
首都机场 酒店	首都机场t2航站楼附近酒店
浙江玉环的酒店	玉环市玉环大酒店
老虎滩海滩	老虎滩海
君山公园	君山
龙水湖国际休闲度假区	龙水湖旅游度假区
长沙橘子洲头附近的酒店	长沙橘子洲景区酒店
巴东巴山悦景	巴东巴山悦景酒店
上海野生动物园接送	上海野生动物园接送班车
白日梦精品民宿	白日梦名宿
云南昆明西南林业大学附近酒店	昆明西南林业大学酒店
博鳌中原镇	博鳌附近的酒店
千岛湖联票	千岛湖门票套票
85度海逸酒店	香港8度海逸酒店
皇家加勒比其他邮轮	皇家加勒比邮轮
武汉杭州	武汉 杭州
越南签证三个月	越南五年签证
汉庭南京朝天宫酒店	南京汉庭朝天宫酒店
北京西城区德胜门附近的酒店	北京市德胜门外大街酒店
长隆大马戏年票	长隆大马戏
香港电话一日卡	香港电话上网卡
拾光旅社	拾光旅舍
山那边	山这边
旅游签证 日本	日本签证个人
亚美国际	亚美酒店
山东枣庄山亭葫芦套风景区全票	山东枣庄山亭葫芦套风景区
昆明恬舍湖景精品客栈	昆明恬舍客栈
遂川县	遂川县酒店
上海浦东机场T2送机	上海浦东国际机场t2
特罗姆瑟极光	特罗姆瑟
厦门出海船票	厦门游艇包船
西藏跟团游5天4晚	西藏跟团游5天
青岛海底世界门票 夜	青岛海底世界门票夜场
大围山七星岭	浏阳大围山七星岭
日本免税店jie	日本免税店
深圳东部华侨城门票年	深圳东部华侨城景区门票
北京旧宫尚客优酒店	汉庭北京旧宫酒店
温州惠民路	温州锦绣路与惠民路交叉口酒店
仙桃到杭州	杭州到仙桃
广州大学城外环东路178号	广州大学城外环东路280号
福都宾馆	福都商务宾馆
吉林 延边	延边
虎门名宿	虎门民宿
菲律宾海豚湾度假村接送	菲律宾海豚湾度假村
南方医科大学中西医结合医院	南方医院
深圳金中环	深圳金中环服务公寓
西土城地铁站附近酒店	西土城酒店
千岛湖民宿整栋	千岛湖名宿
嘉一	嘉 一
合肥经开区酒店	合肥经开区
邹城火车站附近的酒店	邹城西门口
境外上网套餐韩国	境外上网韩国
金叶子复式公寓	金叶子公寓
无锡融创乐园大学生	无锡融创乐园门票大学生
武汉市7天酒店	武汉 七天
融创游乐场门票	融创乐园
湖与·迷海	湖与，迷海
杭州水博园道谷酒店亲子酒店	杭州水博园·道谷酒店
昆明云闲居茶文化主体酒店	昆明云闲居茶文化主题酒店
扬州恐龙	扬州恐龙谷
无锡租房	无锡日租房
西安机场旅途缘聚商务	西安咸阳国际机场旅途缘居商务宾馆
千岛湖绿城蓝湾	杭州千岛湖绿城蓝湾度假酒店
北京 国家博物馆讲解	国家博物馆北京
风彩楼	风采楼
杭州雷峰塔+西湖游船票	杭州雷峰塔西湖夜游半日下午
露营 武汉	露营武汉
九江外国语学校附近的酒店	九江双语实验学校
三亚海棠湾天房洲际度假酒店海洋餐厅晚餐	三亚海棠湾天房洲际度假酒店餐厅
阳光大厦酒店	阳光大厦
三亚山海天傲途格精选	三亚山海天大酒店，傲途格精选
塞班 旅拍	塞班岛跟拍
毕业照	毕业照跟拍
亚特兰蒂斯 早餐	亚特兰蒂斯晚餐
桂林日月双塔附近酒店	桂林两江四湖附近酒店
温州瑞兴.W酒店	温州瑞兴大酒店
熙悦精品公寓	悦熙精品公寓
东方航空官方直营店	东方航空旗舰
四川若尔盖	成都若尔盖
成都几个火车站	火车站成都
宁波到恩阳	恩阳到宁波
上海皇冠假日	上海虹桥皇冠假日
长沙特色美食	长沙特色自助午餐
银座佳驿济南文化东路店	银座佳驿济南东环国际广场店
南澳半岭山居民宿	南澳半岭
成都富力史丹尼国际公寓	成都富力史丹尼国际公寓c座
成都天堂岛海洋乐	成都天堂岛海洋乐园亲子
西安陕西省历史博物馆讲解器	西安陕西历史博物馆语音讲解
重庆西站到北站	重庆北到重庆西站
广州至郑州	广州到郑州
郑州到上蔡	郑州到上蔡县
玉龙雪山拍照	玉龙雪山跟拍
西北小环线敦煌	敦煌 环线
常州有哪些玩的地方	常州有啥好玩的地方
杭州垃圾街美食一条街酒店	杭州美食街
武汉如家精选酒店	武汉如家酒店
北京钟楼鼓楼	北京钟楼
崇左名宿	崇左的民宿
万达艾美酒店	万达富力艾美
鼓浪屿套票	鼓浪屿联票5大景点门票
双十一红包	双11红包
海南三亚民宿短租可做饭短租	海南 三亚 民宿 短租 可 做饭 短租
成都峨眉山御泉湾酒店	峨眉山御泉湾
温泉別墅	温泉别墅温泉
新乡周边两日游	新乡2日游
厚街国际大酒店钟点	厚街国际大酒店
西安咸宁东路酒店	西安西北二路酒店
潜江江汉艺术职业学院	潜江江汉艺术职业学院酒店
福州平潭岛住宿	福建平潭岛酒店
普吉塔湾海滩度假酒店	普吉岛海滩度假酒店
中翔雷迪森温泉度假酒店绍	中翔雷迪森温泉度假酒店
杭州南附近酒店	杭州南站
兰州双城门酒店	兰州步行街
故宫附近的酒店	故宫附近酒店
清莱的当地玩乐	清莱一日
哈乌尔河景	哈乌尔河景区优惠电子票 免预约 呼伦贝尔 额尔古纳
丰顺龙归寨瀑布酒店	丰顺龙归寨瀑布酒店温泉
韩国流量 	韩国流量移动
杭州漫曲千岛湖民宿	千岛湖漫曲民宿
南京住哪里	南京住
北京宜必思酒店鼓楼大街	宜必思北京鼓楼大街地铁站酒店
上海迪士尼乐园1日游	上海迪士尼1日游
邯郸到广州	邯郸至广州
过年去哪玩	过年去哪里旅游
泰山由行	自由行泰山
厦门杏林主题酒店	厦门杏林酒店
郑州到萧山机票	萧山到郑州的机票
东京往返全日空	全日空东京
静安citigo	静安公园citigo
珠海三日游自由	珠海三日
肃宁到沧州	沧州到肃宁的火车
郑州到潮州	潮州到郑州
张家界伟斯特大酒店	张家界韦斯特大酒店
崇州市-鸡冠山森林公园附近的酒店	崇州市鸡冠山
湖南中医药大学	湖南中医药大学附近酒店
浙江千岛湖洲际	杭州千岛湖洲际度假酒店
长隆欢乐城	欢乐长隆
香格里拉拉逸姆	香格里拉逸姆
厦门自由行5天4晚双人	厦门五日自由行
龙腾 年卡	龙腾年卡
鸡西市委招待所	鸡西市委机关招待所
绿城舟山	舟山绿城酒店
惠州簏风酒店	惠州酒店
广州长隆欢乐世界水上乐园套票中高考	广州长隆欢乐世界水上乐园套票
吴哥窟窿导游	小吴哥窟导游
北京地铁新街口站附近的酒店	北京新街口地铁站酒店
威海成山头风景区门票	威海成山头门票 索道
深圳南山区	深圳市南山区酒店
无锡古运河	无锡江南古运河
汉口到应城	武汉到应城
从北京出发到天津一日游	北京出发天津
郑州方特免排队门票	郑州方特成人票
白马井到海口火车站	白马井到海口东站火车
建阳旅游	建阳一日游
阳江闸坡客运站	阳江站
英德白水寨	英德白水寨假日酒店
苏州七里山塘街文旅花间堂	苏州山塘街花间堂
日本交通卡kitaca	日本 交通 卡 kitaca
移动充值卡全国	全国充值卡
上苏杭五日游	苏杭五日
迪拜旅游保险	旅行保险迪拜
舟山沈家门翰	舟山沈家门大酒店
锦绣香江温泉城门票	锦绣香江温泉
青年旅舍昆明	昆明青旅
国庆跟团游成都	国庆旅游成都
浏阳茴香小镇	浏阳茴香
乌镇乌村民宿	乌镇住宿民宿
武汉纽宾凯尚居酒店	武汉纽宾凯光谷国际酒店
大理环洱海一日游班车	大理环洱海一日
北京温泉室外私汤小院可烧烤	北京周边私汤温泉酒店
上海迪士尼门票二曰	上海迪士尼二日门票
西宁海友	海友西宁莫家街酒店
9座租车兰州	兰州租车7座
葛仙村枕山宿特色酒店酒店套餐	葛仙村枕山宿特色酒店
暑假珠海长隆企鹅酒店套票3天2晚	珠海长隆企鹅酒店套票三日亲子
西部航空值	西部航空
深圳两房一厅酒店	深圳三人房酒店
中国移动省内流量包	中国移动流量包
南宁兴宁区酒店	南宁市兴宁区第二初级中学
台儿庄 门票	枣庄台儿庄古城门票
三亚friendly民宿	三亚FRIENDLY民宿
张家港国贸精品酒店	张家港国贸
南京千树cityhome	南京千树cityhome酒店
桐庐县-芦茨度假区	杭州桐庐县-芦茨度假区酒店
长春市长春龙嘉国际机场T2航站楼酒店	长春龙嘉机场 
湛江 鼎龙湾	湛江鼎龙湾国际海洋度假区酒店
湖北武汉沙湖考试院	武汉江夏区湖北经济学院酒店
伊宁市温州大酒店	伊宁温州大酒店
舟山朱家尖连锁酒店	舟山市朱家尖酒店
台北 名宿	台北的民宿
水巷青旅	水巷青年
贵阳延安西路民宿	贵阳北站民宿
贵阳租车9座	贵阳商务车租车
秦皇岛人民日报疗养院	秦皇岛人民日报社疗养院
巽竂湾伴山伴海	巽寮湾伴山伴海
海口火山口一日游	海口火山口地质公园一日游
南京玄武区	玄武
广州出发普陀山	广州到普陀山
武汉洪山区虎泉地铁站附近酒店	武汉虎泉酒店
千岛湖度假民宿	千岛湖民宿
锦绣香江	锦绣 香江
周口市周口幼儿师范学校酒店	周口市开发区实验学校
浦城到建阳	建阳到浦城汽车
南京良竺艺术民宿	南京良竺
亚龙湾美高梅度假酒店 	美高梅亚龙湾
汉中青木川古镇门票	陕西汉中市青木川古镇
北京青年假日旅店	青年旅店北京
阳澄湖半岛旅游度假区	阳澄湖半岛度假区
成都出发西藏跟团游	成都出发跟团西藏游
番禺莲花山公园	番禺莲花山旅游区
东京一日游奥特莱斯滑雪	东京一日游奥特莱斯滑雪场
景德镇自己做陶瓷	景德镇陶瓷diy
焦作中站区酒店	焦作汽车客运总站
福州dao	福州到
长沙民宿麻将	长沙 五一广场 麻将 民宿
哈尔滨机场巴士	哈尔滨机场大巴线路
徐州医科大学附属医院东院	徐州医科大学附属医院
启东海边酒店	启东黄金海滩附近的酒店
银杏湖病管	银杏湖
芬兰官方航空	芬兰航空
上海千禧海鸥	上海千禧海鸥大酒店
厦门海悦山庄酒店新套餐	厦门海悦山庄双11
木守西溪酒店	木守西溪
长白山一日游南坡	长白山一日游北坡
湖南长沙世界之窗门票夜	湖南长沙世界之窗一日夜
日本dianhuaka	日本手机流量卡
重庆大堂诺亚酒店	重庆大唐诺亚酒店
北京野餐	北京 野餐
台湾自由行 签注	台湾入台证多次
怀化汽车东站附近的酒店	怀化汽车西站酒店
惠州机场租车	惠州当地租车
三明 酒店	三明酒店
郑州丰乐园景点	郑州丰乐园
浙江音乐学院国际交流中心	浙江音乐学院附近酒店
博莱顿国际公寓	广州铂莱顿国际公寓长隆万达店
假日阳光商务休闲宾馆	假日阳光商务宾馆
鼓浪屿红地毯趣味蜡像馆	鼓浪屿蜡像馆
南昆山翠兰谷度假酒店	南昆山兰翠谷
威利斯水上乐园	威尼斯水上乐园
华清吃	华清池
合肥钟点房	合肥钟点房6小时
岘港 潜水	岘港一日
空铁联程	空铁联运
清远奇洞温泉度假村酒店	清远奇洞温泉度假酒店
仙本那ow潜水证考证60岁	仙本那ow潜水证考证
上海 半岛 下午茶	下午茶上海
重庆市日月光中心广场附近民宿	重庆市解放碑步行街民宿
贵阳温泉加酒店	贵阳温泉酒店
肇庆端州区大润发附近的酒店	肇庆端州区酒店
朴墅精品民宿	朴墅民宿
云南海景度假酒店	云南海景
杭州市余杭区临平地铁站	杭州市余杭区临平第一中学
安吉县中心	安吉县酒店
贵州4日	贵州4日3晚
新品 汉庭酒店北京三里屯店	汉庭酒店北京三里屯店
游漓江竹筏门票	漓江竹筏
澳门出行指引	澳门交通
美憬阁	美憬閣
郑州热气球	热气球郑州
火车站	火车 站
武夷山两日游套票	武夷山门票二日
长春吉大二院附近的宾馆	长春吉大一院附近的酒店
兰州接机送西宁	西宁接机送机
厦门海洋之星酒店	厦门海洋之星快捷酒店
广州长隆野生动物世界快捷^_^	广州长隆野生动物世界长隆
成都双流国际机场-T1航站楼	成都双流国际机场t1航站楼
黄山宏村景区内的酒店	宏村住宿
沂水龙岗大酒店价格	沂水龙冈大酒店
天桂山一日游	天桂山
杭州到南宁往返机票	浙江到南宁飞机票
郑州冰雪城堡门票	冰雪城堡郑州
春晓世贸希尔顿	春晓世茂希尔顿逸林酒店
重庆希尔曼酒店	重庆希尔曼艺术酒店
神丽峡风景区	神丽峡景区
包车 西宁	西宁包车游
7天优品·成都春熙路地铁站店	七天连锁成都春熙路步行街店
翠湖国家城市湿地公园	翠湖湿地公园
斯米兰两日游艇	斯米兰二日
青岛四日游自由行	青岛4日自由行
丹江口金宝利商务宾馆	丹江口市金宝利大酒店
大围山滑雪场	大围山滑雪
曼谷华欣往返	曼谷 华欣 往返
三亚海棠湾万达希尔顿逸林晚餐	三亚海棠湾万达希尔顿逸林
重庆颂泽酒店（同景国际城店）	重庆颂泽酒店
悅城龍母	悦城龙母
茂县九鼎山国际大酒店	茂县九顶山国际大酒店
上海出发 大明山	上海到大明山
秦皇岛北戴河别墅酒店	北戴河海景别墅
麗枫南昌	麗枫酒店南昌
三峡飞成都	成都三峡
7天连锁酒店精明路店	7天连锁酒店胭脂路
菲律宾水屋	菲律宾 水 屋
贵州荔波大小七孔附近住宿	贵州荔波大小七孔东门附近酒店
大明山景区附近温泉酒店	温泉大明山
护照新加坡	个人护照办理新加坡
杭州振宁路地铁站酒店	杭州振宁路酒店
贵洲毕节旅游景点	贵州毕节旅游景点
锦江之星 王府井 北京	北京王府井锦江之星
四川大熊猫基地 幼	四川大熊猫基地
峨眉山濮温泉	峨眉山温泉
云浮市新兴天露山旅游度假区酒店	云浮市天露山旅游度假区酒店
鼓浪屿五景点联票	鼓浪屿联票
巴夫洛水上乐园	巴夫洛水世界
杭州东站高铁站	杭州 东站 高铁 站
巴厘岛spa按摩	巴厘岛女性spa
武汉欢乐谷湖北人买的票	武汉欢乐谷票
广东珠海长隆海洋王国	珠海长隆海洋王国家庭亲子门票
东京到大阪夜行巴士	东京大阪夜行巴士
万仙山民宿	万仙山南坪民宿
上海外滩英迪格	上海外滩英迪格酒店
丽达酒店	丽达
流量 香港	流量卡香港
上海苏州温泉一日游	上海温泉一日
民宿北戴河	北戴河民宿两室一厅
珠海长隆海洋王国旅拍	珠海长隆跟拍
宜家家居郑州商场(建设中)	郑州宜家酒店
云南中青国际旅行社	云南中国国际旅行社
如家精选宋家庄	宋家庄如家
长隆 民宿	长隆附近民宿
北京租车自驾游北戴河	自驾游租车北京
宝鸡汽车北站附近的酒店	宝鸡汽车西站
包车 新疆	新疆包车旅游
三亚海边公寓	三亚海边度假公寓
长安乌沙	长安镇乌沙
佛山一日	佛山一日游
普吉岛 免税	普吉岛免税
尚怡酒店	尚怡精品酒店
尤溪县酒店	尤溪县尤溪站酒店
重庆锦囊青年酒店	重庆锦囊酒店
韩国临时电话卡	电话卡韩国
德州市	德州市酒店
弥勒旅游	弥勒旅游攻略
租游艇 青岛	游艇青岛
芬兰和冰岛	芬兰冰岛
雨崩村	梅里雨崩
花都卡尔文	花都卡尔文酒店
上海银川	上海 银川
丽江租车服务	租车丽江
成都新华宾馆	成都新华宾馆(文殊院宽窄巷子)
石家庄如家酒店建华北大街店	石家庄如家商旅酒店
曼谷星罗海底世界	【1分钟出票 免护照】曼谷海洋世界暹罗水族馆大门票暹罗海洋世界
香港两日游厦门	二日厦门
潍坊泰华假日广场	潍坊泰华广场
江北机场t2附近酒店	江北机场附近的酒店
兰海国际	兰海国际大酒店
锦江之星酒店(杭州经济开发区店)	锦江之星杭州下沙开发区店
天津格林豪泰酒店桂苑路	天津格林豪泰酒店中北大道店
江西2日游	江西两天一晚
十堰武当山景区门票	十堰武当山一日门票
上海出发南京两日游	上海出发南京二日游
吴哥超豪华酒店	吴哥豪华酒店
日本往返船票	日本船票
迪士尼功略	迪士尼攻略
三亚免税攻略	三亚免税店攻略退税
祥符区开封酒店	开封县祥符区
常德武陵区	常德市武陵区酒店
宁夏中卫沙坡头周边民宿	中卫沙坡头民宿
国贸附近酒店	国贸附近
eha电竞	Eha电竞酒店
深圳玩美假期旅行社法国签证	[上海送签]法国签证欧洲申根签多次个人自由行旅游加急
土耳其跟团儿	跟团土耳其
锦江之星锦州	锦州锦江之星酒店
新津区实验高级中学	新津中学
全季酒店陆家滨	全季酒店 陆家滨
旅拍圣托里尼	旅拍圣托里尼岛
醉香慕谣	醉乡慕谣
惠东华家班	惠东巽寮湾华家班
平潭的酒店	酒店平潭
碧峰峡景区门票	碧峰峡
西安莫泰酒店	莫泰-西安钟楼北大街地铁站店
韶关云门山大门票	韶关云门山缆车票
宜昌三峡瀑瀑布	宜昌三峡瀑布
日本东京迪斯尼	日本东京迪士尼门票
重庆的七天连锁酒	七天连锁重庆
别墅拈花湾	拈花湾房间
分宜县的酒店	分宜
黄冈市中职学校	黄冈市黄冈职业技术学院
南京都市118	南京都市118酒店
长沙逸胜主题酒店	长沙逸盛主题酒店
中国防空博览园	中国防空博览园军事体验区
美的鹭湖度假区	美的鹭湖
茂名市人民医院	茂名市人民医院附近的酒店
yuekiangwan	月亮湾
霸州日月潭丝汤	霸州茗汤日月潭
大连旅顺一日游	大连旅顺纯玩一日游
跟团芜湖方特	芜湖方特梦幻王国跟团
汕头玩	汕头纯玩
广东佛山景点	佛山景点
宝泉风景区宾馆	宝泉一日宾馆
日本 地铁卡	日本西瓜卡icoca
嘉兴西塘曼途精品民宿	西塘曼途精品民宿西塘
环球影城层快捷票	环球影城快捷票
芜湖方特门票带酒店	芜湖方特门票酒店
上海浦东大道德平路酒店	上海德平路站附近的酒店
新疆 五一	国庆新疆
惠州双月湾加勒比海景酒店	双月湾加勒比海景酒店
武汉自驾一日游	武汉周边自驾一日游
天津花园酒店	花园酒店天津
三亚跟团含机票	报团三亚旅游含来往机票
嘉兴海盐开元	浙江海盐开元
广州珠海双长隆亲子游自由行	广州珠海双长隆亲子游三天自由
武汉到重庆的游轮	武汉至重庆长江邮轮
潍坊泰华民宿	潍坊泰华城附近民宿
杭州桐洲岛	杭州桐洲岛酒店
白虎自助餐	长隆酒店白虎餐厅
日本寿喜烧	日本 寿 喜 烧
蓬莱极地世界	蓬莱极地海洋世界
苏州山塘街小吃	苏州山塘街
西江苗寨循美	西江循美
上海迪士尼乐园门票高考生	上海迪士尼迪士尼门票学生
澳门银河天上	澳门银河天
嘉兴西塘原宿临河精品客栈	嘉兴西塘古镇景区内住宿临河
上海金桥(地铁站)酒店	上海市浦东金桥酒店
富国岛深潜水	富国岛潜水
连云港度假村	连云港度假
大理洱海公园附近住宿	大理下关洱海酒店
如家光谷	如家商旅光谷
三亚亚龙湾丽思卡尔顿	三亚亚龙湾丽思卡尔顿酒店
岭南天地酒店	岭南新天地
兰州周边游两日	兰州周边两日游
大连希尔顿欢朋	大连希尔顿酒店
长春职业技术学院附近的酒店	长春理工大学南校区附近的酒店
维也纳酒店塘下	塘下维也纳酒店
吉林省延吉市	延吉市的酒店
松原到长春客车	长春到松原客车
普吉岛 住宿	普吉岛的酒店
成都到东营	东营到成都
长沙通程大酒店	长沙通程国际大酒店
苏州欢湖	苏州太湖欢
九华山 花台	九华山花台
三仙山八仙渡联票	八仙渡三仙山
承德维也纳酒店	承德维也纳国际酒店
黄山环线	黄山自行游路线
桐庐雷	桐庐雷迪森度假酒店
云南 机票	云南往返机票
台湾旅游	台湾旅游跟团
维也纳国际酒店肇庆中心	肇庆维也纳国际酒店
国内联通流量	联通境外流量充值包
星奇塔	星奇塔門票
亚布力阳光度假村滑雪场	亚布力阳光滑雪场门票
定州到成都	成都到定州
东方之门附近酒店	东方之门附近的酒店
鸣沙山拍照	鸣沙山旅拍
美国电话卡att	美国电话att
昆明滇池风景区商圈酒店	昆明滇池酒店
天水汽车西站	天水汽车站
国内航空行李托运规定	联航行李托运收费标准
快手极速版	快手极速版。
十八楼	十七楼
宁波到镇雄	宁海到镇雄
加拿大签证加急	代办加拿大签证
武汉至重庆长江邮轮	武汉到重庆游轮
长隆大马戏和水上乐园	长隆水上乐园大马戏
天津五星	天津五星酒店
青海青旅	青海旅社
欧洲 一价全含	欧洲游一价全含
重庆仙女山长松国际大酒店	重庆武隆仙女山长松国际大酒店
连南瑶族自治县的酒店	连南瑶族自治县寨岗镇
象山 阿拉的海	象山阿拉的海
n酒店合肥	n合肥
上海谷迪假日酒店（乐园店）	上海谷迪假日酒店迪士尼
白水寨 嘉华	嘉华白水寨
optus电话卡	celcom电话卡
福州 土楼	福州土楼
汉庭优佳杭州武林门湖墅南路	汉庭杭州武林门地铁站酒店
珠海香洲区人民法院附近的酒店	珠海香洲区吉大路酒店
铜梁区的酒店七天优品	重庆铜梁七天优品酒店
广州锦绣香江大酒店	广州 锦绣 香江 大 酒店
上海应用技术大学奉贤校区	上海商学院奉贤区附近的酒店
千岛湖建国润和酒店标间	千岛湖建国润和酒店
派酒店郑州	派酒店 郑州文化路东风路店
格林豪泰阜阳市阜南县天筑广场商务酒店	阜阳市阜南县
合肥到蚌埠的汽车票	蚌埠到合肥
北纬37℃星空营地	北纬37度星空营地
附近的民宿	附近 的 民宿
郑州的景点	郑州景点门票免费
厦门曾厝垵晓风客栈	厦门晓风客栈
花间堂 云南	云南花间堂酒店
郑州东站到宋城路	郑州东站到郑州站
中国联航行李额	中国联航行李
南豪酒店	南豪
北大湖clubmed	clubmed北大湖
无锡灵山大佛附近的酒店	无锡灵山大佛附近酒店
太姥大酒店	太姥酒店
温州学院路酒店	温州大学学院路校区
环游澳门	澳门环游
日本跟团3日游	日本三日游
慈利站	慈利火车站
北京 主题 酒店	北京主题酒店
台山那琴半岛酒店跟团	台山那琴半岛
南昌江西财经大学(蛟桥园校区)酒店	南昌市江西财经大学(蛟桥园校区)酒店
吉隆坡雪兰莪天空之境半日	吉隆坡雪兰莪天空之境
山东省城市服务技师学院	山东省商业职业技术学院
越南按摩suspa	即时确认 越南旅游芽庄一日游 体验芽庄su spa越式精选按摩套餐
香港迪士两日门票	香港迪士尼乐园2日门票
贵阳骑马场	贵阳骑马
西双版纳纯玩自由行	西双版纳自由行
珠海长隆海洋王国套票2天1晚	珠海长隆海洋王国套票
玉龙雪山包车一日游	玉龙雪山一日游包车
横店影视	横店影视城联票
日本短信卡	日本旅游电话卡
f1上海站	f 1 上海 站
飞机加火车	火车转飞机
嘉兴万豪自助	嘉兴万豪酒店集团
地铁十号线	地铁4号线
大峡谷森林公园	大 峡谷 森林 公园
许昌月伴湾酒店	许昌月伴湾商务酒店
胜利宾馆	胜利商务宾馆
西双版纳5晚	西双版纳两晚
五台山山缘亭阁客栈	五台山缘亭阁客栈（五爷庙店）
重庆带娃一日游	重庆亲子一日游
西安国际医学中心	西安国际医学中心医院
普吉机场接机送机 趴趴	普吉机场接机送机
福建福州建筑学校附近的酒店	福州福建师范大学协和学院酒店
门票隐贤山庄	隐贤山庄门票
芜湖市第二人民医院附近的酒店	芜湖市第二人民医院
珠海长隆海洋王国一日票	珠海长隆海洋王国一日门票
河南度假村	河南 度假
御泉谷温泉度假酒店	御泉 谷 温泉 度假 酒店
内蒙乌兰察布蒙古包	乌兰察布蒙古包
西藏跟团游火车进飞机出	西藏跟团游火车飞机
莫泰连锁酒店上海虹	莫泰酒店上海虹口
威海私人导游	导游威海
旅行团日本	日本旅游团
长沙站到湘潭	湘潭北到长沙南
布吉东站	布吉地铁站
青島民宿	 青岛民宿
杭州上峰电商产业园酒店	杭州东新中大银泰城附近酒店
美国流量卡	美国sim
张家界跟团游三天二晚宿州	张家界跟团游三日
香港如心南湾海景	香港南湾如心
东都酒店	东都
信阳师范学院洗浴	信阳师范学院
碧地寒楼	僻地寒楼
重庆周边 三日游	重庆周边日游
八达岭长城拦车	八达岭长城租车
海口观澜湖度假温温泉	海口观澜湖度假温泉
普吉岛  秀	普吉岛女神
郑州市水上乐园	郑州水上乐园
银滩海边小筑客栈	银滩海边小筑
香格里拉4日自由	香格里拉4天3晚自由行
上海迪士尼 礼宾	上海迪斯尼礼宾服务
中央芭东伴我入眠	中央芭东伴我入住
江苏省南通市通州区	南通通州区酒店
青海旅游6天5晚莫高窟东台吉	青海湖茶卡盐湖敦煌六天
东京迪士尼 海洋	东京迪士尼门票1日
泉州丰泽区华侨大学附近的酒店	泉州华光学院附近酒店
久龙酒店	久龙大酒店
大连 喜来登	大连喜来登
macro polo 香港	香港marco polo
如家乳山青山路老汽车站店单人	如家乳山青山路老汽车站店
苏连托	苏莲托
无锡融创雪世界酒店 门票	无锡融创雪世界 双人
商丘市第一人民医院	商丘市回民中学
点对点 普吉	普吉岛酒店接送酒店
景咖精品民宿	景咖名宿
咸宁塞纳左岸酒店	咸宁塞纳风情主题酒店
台北一日他	台北一日
lex relax spa	lets relax spa
黑河的酒店	黑河住宿
长沙芙蓉中路酒店	长沙芙蓉广场附近酒店
梦幻家园门票	梦幻家园
宁波普陀山拜佛跟团两日游	宁波普陀山二日游纯玩
西安到绵阳高铁	绵阳到西安北站
77优品	77优品酒店
衡阳一日游	衡阳一日
中山时代苏豪酒店	中山时代soho酒店
水水间智能公寓	山水间智能公寓
武汉江夏区藏龙岛酒店	武汉藏龙岛酒店
无锡拈花湾D套餐	无锡拈花湾套餐
盛之乡温泉渡假酒店	盛之乡温泉度假村
接机服务拉萨	拉萨市到机场送机
成都去西岭雪山包车	成都西岭雪山包车
奥南去兰塔 	奥南去兰塔岛
西安科技八路酒店	西安科技二路酒店
双十一 希尔顿	双十一希尔顿酒店
兰州海关附近的酒店	兰州西关附近的酒店
橫琴民宿	横琴民宿
黄山风景区山顶	黄山风景区山顶住宿不要门票
赤壁站	赤壁火车站附近的酒店
清池温泉	清池温泉酒店
天眼直通车	天眼 直通车
东澳岛2天一夜双人	东澳岛2天一夜亲子
深圳市南山区科苑南路	深圳市南山区科发路
韩国济州dao	济州岛韩国
桔子酒店 黄龙	桔子酒店黄龙
嘉兴秀洲区	嘉兴市秀洲区附近的酒店
大梅沙京基喜来登大酒店	大梅沙京基喜来登度假酒店
柏斯特	柏斯特酒店
太仓市南园东路1号	如家太仓上海东路店
武汉理工大学鉴湖校区	武汉理工大学南湖新校区
时光联锁酒店	时光连锁酒店
胡志明接机	胡志明接送机
如家西湖新店	如家精选西湖湖畔
七仙岭温泉山庄	七仙岭温泉
塞班军舰岛蝴蝶潜	塞班军舰岛蝴蝶
全季西安钟楼省政府酒店	全季酒店西安钟鼓楼
凯悦宾馆	凯悦商务宾馆
南昌一中	南昌二十六中
青城外山	青城外山 都江堰
恐龙园温泉	恐龙谷温泉
黄果树万峰林小团	万峰林黄果树
中骏广场	中骏广场2期
三亚出港邮轮	邮轮三亚
南京如家	南京如家商旅酒店
维也纳国际酒店（杭州余杭高铁店）	杭州维也纳国际酒店余杭高铁
丽水民俗	丽水 民宿
广州太古汇丽枫酒店	广州丽枫酒店天河公园
德清雷迪森	德清雷迪森国际会所莫干山别墅
广州从化温泉自由行	从化温泉2日
三亚情侣双人游 含机票	三亚情侣机票
张家口市第一中学	张家口市第十九中学
昆明旅游景点攻略自由行	昆明的攻略
丽水火车站	丽水客运东站
鸟巢门票	门票鸟巢
广富林文化遗址门票	广富林遗址公园
房车租车	房车 租
Loft	loft
大理国际会展中心	大理站附近酒店
外滩宝格丽	上海外滩宝格丽酒店
北京首都国际机场攻略	北京首都机场国际
从化明月山溪温泉别墅木栈楼	广州从化明月山溪温泉度假别墅
SM性爱主题酒店	sm主题酒店
优壹朵	优壹朵酒店
郑州到广州南	郑州东到广州南
菲利宾globe充值卡	菲律宾globe充值
漳州东山岛附近的别墅	福建漳州东山岛海边别墅
烟台到重庆的机票	重庆到烟台。
新加坡圣淘沙sea海洋馆门票	新加坡圣淘沙岛海底世界
深圳光明区民宿	深圳国际会展中心附近民宿
敦煌自驾旅游攻略	敦煌自驾游攻略
陵水富力湾	海南陵水富力湾
徐州游玩攻略	徐州游攻略
株洲方特门票亲子	方特门票株洲
海悦度假酒	海悦度假
保山邦腊掌温泉酒店	保山邦腊掌
崇礼双龙滑雪场	崇礼 双龙 滑雪 场
旌德站	旌德的酒店
观前街 全季	观前街全季
一井冈山茨坪	井冈山茨坪
达州到成都东	成都达州
哈尔滨到西双版纳	西双版纳到哈尔滨
健为县	犍为县
漳州东山岛民宿朴宿海景民房	漳州东山岛民宿南厝
下龙湾接车	下龙湾用车
北京民宿三人	北京民宿八人
巢湖一中	巢湖学院附近的酒店
保险	酒店保险
深圳城市连锁酒店	深圳城市快捷酒店
青城山见山别墅	青城山别墅
银川市第五中学	银川市回民中学附近的酒店
南宁东至全州高铁	全州南到南宁东的火车票
青旅南宁	南宁青年旅社
昆明旺马假日酒店	昆明旺马
长沙至乌鲁木齐	长沙到乌鲁木齐
济宁周边自驾游	济宁周边游
长春到长白山拼车	长白山到长春
丽江古城客栈四方街	丽江四方街客栈
北京古北水镇 	北京古北水镇景点
宝鸡的名宿	宝鸡民宿
香港九龙香格里拉	香港香格里拉
徐闻民宿	徐闻渔港海景民宿
扬州市旅游热门景点自驾游	扬州一日自驾游
云南建水美食	建水美食
泰国曼谷廊曼机场接机中文12人	泰国曼谷廊曼机场接机中文
苏州至周庄	苏州到周庄古镇
安徽警官职业学院附近酒店	安徽国际商务职业学院
北京市华北电力大学酒店	北京市北京化工大学东校区酒店
东莞市内游	东莞旅游
西安临潼悦椿温泉酒店自助餐	西安临潼悦椿温泉酒店
夏河诺尔丹	甘南夏河诺尔丹营地
苏州摩天轮乐园票价	摩天轮乐园苏州
深圳海鲜一条街	深圳海鲜街
上海三日亲子游 常州	上海亲子三日
上海大学宝山校区地铁站	上海大学宝山校区 北门
新桥机场商务贵宾厅	新桥机场vip贵宾休息室
乌鲁木齐英朗主题酒店	乌鲁木齐英朗主题酒店昆明路店
连云港市中等专业学校	连云港市实验学校
太阳布落	太阳部落
美好丽致	美好丽致酒店
惠州农庄旅游	农庄惠州
美龄宫当天门票	美龄宫门票
上海亲子农家乐	上海农家乐4人别墅
昆明努江	昆明怒江
厦门双层环岛观光巴士	厦门环岛巴士
兰州出发游跟团陇南	陇南周边游兰州出发
韩签证江西	江西签证
伊犁一日游	伊犁旅游团跟团游
泸沽湖真美度假连锁客栈	泸沽湖真美连锁客栈
西宁五和风尚	西宁五和宾馆
张家口十中	张家口六中
薄荷岛 ow	薄荷岛潜水AOW
杭州开元森泊晚餐	杭州开元森泊度假酒店自助餐
三亚吴支洲岛一日游自由行	三亚吴支洲岛一日游门票
台州市府大道商圈附近的酒店	台州市台州椒江区市府大道酒店
厦门鼓浪屿4日	厦门鼓浪屿四天三晚自由行
丽江市红太阳广场	丽江红太阳广场
石家庄如家西二环槐安路酒店	石家庄市新华区和平西路如家
洛杉矶跟团游带环球影城	洛杉矶跟团游环球影城
连江县酒店	连江县的酒店
海口火车站时刻表	海口汽车东站时刻表
威海亲子游攻略	威海攻略
悉尼大游软	悉尼游
天安门东美食	天安门美食
兰州出发青海	兰州到青海旅游
贵阳龙洞堡机场里面酒店	贵阳龙洞堡机场
三亚旅游团拼团	三亚跟团纯玩
金沙县的酒店	金沙县
新加坡sea海洋馆加环球影城门票	新加坡环球影城sea海洋馆套票
景德镇满庭居	景德镇满庭
香港迪斯尼酒店 	香港迪士尼乐园度假区
上海迪士尼乐园半自助旅游	上海迪士尼多日游
北京首都机场丽豪T3	北京首都机场丽豪
澳洲上网卡	澳洲4g电话卡
如家快捷哈尔滨国展中心店	如家哈尔滨国展中心店
俄么塘酒店	俄么塘住宿
飞机提前	飞机晚点
台湾电话卡广州自取	台湾电话卡自取
上海迪士尼门票1天	上海迪士尼乐园门票双人票1日
玉溪情侣主题酒店	玉溪情趣酒店
云庭时光厦门	厦门云时光
胡志明十美奈十芽庄	胡志明美奈芽庄
枸杞岛自由行攻略	枸杞岛三日游
成都武侯祠杜甫草堂门票	成都武侯祠杜甫草堂一日
三亚双人行	双人三亚
城市名人成都	成都城市名人
宁波市宁波工程学院东校区酒店	宁波市宁波财经学院酒店
龙岗区科技城外国语学校	龙岗区外国语学校
武汉海昌海洋公园上海	海昌海洋公园武汉
色达攻略	色达
舟山夕舍	舟山柒+夕舍民宿
漳州东山华福酒店	漳州东山岛华福酒店
万宁石梅湾加井岛船票	万宁石梅湾加井岛
西安唐都医院酒店	西安唐都医院
若只如初见	只如初见
唐山美术馆	唐山工业博物馆
书香客栈潮州	潮州书香客栈
大里到丽江	大理到丽江
新千岁机场快速	新千岁机场
西安榴莲商务酒店	榴莲酒店西安后卫寨
深圳盐田区外国语学校	深圳信息职业技术学院附近酒店
阿里巴巴西溪园区参观	西溪园区阿里巴巴
上海迪士尼皇庭	上海迪士尼度假区
莫干山一千	莫干山一千零
常州西太湖澜悦	常州西太湖澜悦湖景
上海迪士尼门票BIP	上海迪士尼门票 vip
四川6日	四川六天五晚
商洛学院	商洛职业技术学院附近的酒店
短租房 贵阳	贵阳租房
香港境外电话卡	香港境外上网
杭州西湖庐驿精品酒店	西湖庐驿精品酒店
福州贵安世纪金源温泉世界	福州贵安世纪金源温泉大酒店
青岛自由行南宁出发	自由行青岛
菲利宾攻	菲利宾
山东泰山国际青年旅舍	山东泰山宾馆
长沙直木微居	长沙民宿 直木微居
故宫 清明上河图	故宫博物院
杭州至哈尔滨	杭州哈尔滨
亚龙湾半潜船	亚龙湾半潜
青岛帆船公寓	青岛奥帆中心
久栖大理美人鱼海景度假	大理美人鱼海景度假酒店
成都郫县红光银杏酒店管理学院	成都郫县四川工商学院
深圳到西宁	深圳至西宁
大理车站	大理站
福州出发到泰国	福州直飞泰国
舟山嵊泗本岛度假酒店	浙江舟山嵊泗本岛酒店
浦东同派酒店	浦东同派
峨眉山景点	峨眉山风景区
许昌春秋广场	许昌毓秀路酒店
海丽宾雅昆明	昆明海丽宾雅度假酒店
九华漂流	九华天池漂流
日照海上	日照海水浴场
长沙湖南师大附中星城实验中学	长沙湖南师大二附中酒店
双月湾万科海景房	万科双月湾酒店
普吉攻略	普吉自由行
资阳师范校附近的酒店	资阳市资阳师范学校酒店
广西桂林游	广西 桂林 游
厦门如颐	厦门如
广州暨南大学番禺校区附近酒店	广州暨南大学番禺校区酒店
融创万达重庆	重庆融创万达文
合肥出发黄山两日游	黄山二日游合肥出发
南京玫瑰园	南京玫瑰园门票
杭州低碳科技馆附近的酒店	杭州奥体博览中心
双廊海墅	双廊海景
北京南宫五洲植物乐园游乐	北京南宫五洲植物园儿童乐园
浙江丽水民宿	丽水名宿
保定莫凡电影主题客栈	保定莫凡艺术酒店
金华南站	金华汽车南站
四天旅游	四天游
宝鸡九龙山酒店	宝鸡九龙山
防城港金滩老兵民宿	防城港万尾金滩民宿
泸沽湖沐光湖景精品客栈	泸沽湖沐光水岸客栈
万豪88元	万豪300元
南浔古镇大门票	南浔古镇门票当日票
溧阳市温泉酒店	溧陽溫泉酒店
南京鼓楼医院附近的酒店	南京鼓楼医院北院附近的酒店
厦门方特水世界门票	厦门方特水上乐园
JW曲阜	Jw 曲阜
新都桥云顶星空大酒店	新都桥云顶星空别院
乐山市区	乐山市区的酒店
石牛寨缆车	石牛寨门票
西安加利利酒店	西安加利利连锁酒店
惠州大亚湾黄金海岸别墅	惠州大亚湾别墅
恩施5日游跟团	恩施五日游跟团
北京牛街清真寺附近酒店	北京牛街的酒店
常州韭田宾馆	常州韭田精品酒店
稻城亚丁至成都飞机票	稻城亚丁飞机票
99连锁酒店温州五马街店	99旅馆连锁温州火车站二店
台州第一中学	台州科技职业学院
西溪天堂丽呈西轩酒店	杭州西溪天堂丽呈西轩酒店
欢乐世界大马戏	欢乐世界马戏
新加坡市环球影城快速通道票	新加坡环球影城快速票
泉州师范学院附属小学	泉州师范学院
秦皇岛河北科技师范学院酒店	秦皇岛河北建材职业技术学院
海公园度假酒店K	海公园度假酒店
萧山度假酒店	萧山度假
香格里拉三日游纯玩团丽江出发	香格里拉3日游纯玩团丽江出发
鄂尔多斯半日游	鄂尔多斯 半 日 游
银杏村门票	银杏村
如家快捷酒店上海人民广场福州	上海如家快捷酒店人民广场
丰顺鹿湖温泉假日私人别墅	丰顺鹿湖温泉度假村酒店
芜湖市皖南医学院滨江校区酒店	芜湖皖南医学院赭麓校区
万科云城民宿	云城万科里民宿
成都索菲亚酒店	成都索菲亚民族大酒店
珠海御温泉渡假村儿童票	珠海御温泉门票酒店套票2天1夜 庙会大餐门票/云来客栈酒店度假村
涠洲岛亲子民宿	涠洲岛名宿
上海雅阁	上海雅阁精品酒店
婆那加占婆塔 晚上	婆那加占婆塔
凛然温泉度假酒店	凛然温泉酒店
重庆长江一日游	重庆长江索道一日游
斯里兰卡电子签	斯里兰卡签证个人旅游
南昌出发海南	南昌到海南机票
庐江名宿	庐江 民宿
上海如家酒店浦东新区嵋山路	上海浦东新区金高路如家酒店
长沙地铁附近的酒店	长沙地铁2号线附近的酒店
渭南水上乐园	水上乐园渭南
三亚甩尾机票	三亚 机票
广州到大阪的机票	广州至大阪自由行机票酒店
苏州平江 观前民宿	苏州平江观前民宿
青岛维多利亚海景度假酒店	青岛维多利亚海景酒店
上海虹桥机场接机服务	上海送机虹桥机场
菲里顿	菲里顿酒店
皖南川藏线旅游	皖南川藏线线路
上海到章州	上海到漳州
北海半岛海景蜜月度假公寓	北海银滩海景度假公寓
移动wi fi	移动移动wifi
文山实验小学南校区	文山第四中学附近酒店
蓬莱欧乐堡梦幻水上乐园	蓬莱欧乐堡水上
吉州区	吉州区五里小学
茶卡镇租车	茶卡租车
南昆山金叶子	惠州市南昆山金叶子酒店
西藏羊湖两日游	西藏40冰川羊湖二日游
西塘一日游上海出发	西塘一日游杭州出发
温泉临安	临安湍口温泉
亲子礼遇酒店	亲子礼遇
天津邮轮船票	天津轮船票
广州从化望谷温泉别墅	广州从化望谷温泉度假村 复式
西宁格林豪泰火车站分店	格林豪泰西宁火车站
厦门大学亚朵酒店	厦门的亚朵酒店
宁波象山东旦沙滩民宿	宁波象山沙滩客栈
老友记民宿	老友记精品民宿
会员专享价自助餐	会员专享酒店自助餐套餐
肇庆端州区民宿	肇庆名宿
短住民宿云南	云南旅居民宿
福州市第四十中学	福州市第十二中学
珠海中大五院附近的酒店	珠海中大五院酒店
泾阳县的酒店	泾阳县
济南山东医学高等专科学校酒店	济南山东劳动职业技术学院酒店
天水市麦积区旅游景点	天水麦积山风景名胜区门票
清华镇	清華鎮
民生	民生酒店
随心飞机票	机票随心飞
深圳南澳桔钓沙	深圳南澳第一沙滩
杭州森泊水世界	杭州森泊水乐园门票
美憬阁索菲特曼谷维亚酒店	曼谷美憬阁索菲特酒店
信阳到深圳	深圳到信阳
温泉泡池房	温泉私家泡池
常州市恐龙酒店	常州酒店恐龙
南京禄口送机	接机南京禄口机场
沈阳市第二十七中学	沈阳市第四十中学
亚布力森林火车	森林小火车亚布力
西安附近好玩的	西安门票
半自由行	半 自由 行
奧门富都宾馆	澳门富都宾馆
蓝汐顺德	顺德蓝汐
武汉荔枝精选酒店	荔枝精选酒店(武汉光谷金融港店)
福建平潭岛海边酒店	福州平潭岛住宿靠海
上海铂悦酒店	上海铂悦酒店外滩
兰州包车大环线	兰州线路包车
七天贵阳黄河跳	7天连锁酒店贵阳黄河路店
泰国当地跟团旅游10天	泰国游跟团游十日
东莞市东莞大朗镇酒店	东莞大朗镇中心小学酒店
芜湖鸠江饭店（步行街店）	芜湖鸠江饭店酒店
千旅千岛湖	千岛湖浙旅
焦作新乡的酒店	焦作新区酒店
香港迪士尼去澳门	香港迪士尼加澳门
三亚三亚湾万豪	三亚万豪度假酒店
美尔海悦台精品酒店	美尔海悦台酒店
上海陆家嘴世纪大道亚朵S酒店	上海陆家嘴亚朵
成都高新区皇冠假日酒店	成都高新西区皇冠假日
台州温岭滨海大酒店	温岭滨海大酒店
江西宜春温汤镇酒店	宜春温汤镇酒店
海南跟团游 运城出发	海南跟团游海口
宿州罗马假日时尚宾馆	宿州罗马假日商务宾馆
来宾裕达酒店	来宾裕达
红枫岭景区	红枫岭
洛阳两天自由行	洛阳两日
齐长城	齐长城遗址
朝阳师范专科学校附近的酒店	朝阳工程技术学校
宏村民俗	宏村客栈
三亚 club med	三亚club酒店
超级房券成都	成都房券
三亚湾 喜来登	三亚湾喜来登酒店
成都文化宫地铁站附近酒店	成都文化宫酒店
青医附院	青医医疗美容医院
扬泰机场接	扬泰机场
绍兴市鲁迅故里度假区商圈酒店	绍兴市鲁迅故里
东京浅草寺和服租赁	东京和服租赁
长沙七天连锁酒店长沙大学	长沙五一广场七天优品酒店
如家酒店秦张家口	张家口如家酒店
贵阳能辉酒店	贵阳能辉之星酒店河滨公园店
宁波眼科医院	宁波市第二医院
贵阳火车站附近酒店住宿	贵阳北火车站附近酒店住宿
珠海海洋王国歺	珠海海洋王国海底
瀍河	妫河
黔江到重庆的火车票	黔江到重庆
曼谷ibis酒店	泰国曼谷宜必思
西安公园南路酒店	西安西五路酒店
广州野生动物世界门票季票	广州野生动物世界门票
西安维也纳智好	西安维也纳
清远狮子湖别墅	清远狮子湖休闲度假别墅
长沙去凤凰古城两日游	长沙到凤凰古城2日游
国内移动手机充值话费小额	国内移动手机充值话费
太仓七天	7天酒店太仓
天目湖涵田半山度假村	天目湖涵田度假村
新昌到上海	上海到新昌
哈尔滨道理安国街	哈尔滨安国街
宿务至邦劳岛船票	宿务邦劳岛
九江火车战附近酒店	九江火车站酒店
一日游阳江	阳江一日游
接机上海虹桥	接机上海浦东
从化就仙沐园	从化仙沐园
两日香港迪士尼	香港迪士尼乐园2日票
绍兴乔波滑雪门票温泉	绍兴乔波滑雪门票
成都高新区豪生大酒店自助餐	成都高新豪生大酒店
苏州周庄二日游	苏州 周庄 二 日 游
成都宽窄格林豪泰	格林豪泰成都
义乌国际商贸学校	义乌工商学院
福州室内温泉酒店	福州 温泉
亳州威武广场	亳州三中
延步	延布
青秀区的酒店	青秀区人民政府
天台禾酒店酒店套餐	天台·禾酒店
宝鸡九龙山国际温泉酒店酒店套餐	宝鸡九龙山温泉度假酒店
邢台巨鹿的酒店	邢台巨鹿县附近的酒店
南昌二中高新校区	南昌十二中附近的酒店
壹零捌馆	壹零捌
临沂北到泰安	临沂到泰安的汽车票
丽晶重庆	丽晶酒店重庆
山东省青岛第三十一中学	山东省青岛第六十八中学
九寨沟往返车票	九寨沟车票
福州福建省高级人民法院酒店	福州福建省妇幼保键医院酒店
奥莱电竞酒店	奥莱电竞
西安到长沙机票	长沙到西安机票
阳江汉庭优佳酒店	汉庭优佳阳江百利广场酒店
浙江10日游	浙江 10 日 游
海口泰国游	泰国海口
泉州丰泽区华侨大学附近的酒店	华侨大学泉州校区
武安市酒店	武安市的酒店
香港1铜锣湾迷你	香港铜锣湾迷你
张家界一日	张家界 一 日
悉尼包接机	悉尼接机
宜佳精品酒店	宜佳
广州惠福东路酒店	广州广园西路酒店
北海到围州岛船票	北海到涠洲岛船票
北京王府井银地宾馆标间	北京王府井银地宾馆
简家公寓	简家温馨公寓
成都到库尔勒	库尔勒到成都
汉庭 中关村学院桥	汉庭酒店中关村学院桥店
杭州千岛湖如家酒店	千岛湖如家
全季酒店淮河路步行街	全季酒店淮海路
上海迪士尼度假区的门票年卡	迪士尼上海门票 年卡
斯里兰卡4g手机电话上网卡	斯里兰卡电话
杭州的酒店上城区	杭州上城区
涠洲岛目的地海边客栈巴蜀人家	涠洲岛巴蜀人家风情客栈
广州长隆野生动物世界附近民宿	广州长隆附近民宿
连云港宿城八间房酒店	连云港宿城八间房
仪征民宿	仪征名宿
大理古城双廊租车	大理双廊租车
全季市民中心	全季 市民中心
起深圳欢乐谷	欢乐谷深圳欢乐谷
成都旅游小团	成都纯玩小团
广州长隆野香江	广州长隆香江野生
咸宁温泉碧桂园	咸宁碧桂园
广州租车奔驰	广州租车敞篷跑车
莫干山 跟团	莫干山3日游
武夷山印象大红袍酒店	武夷山大红袍酒店
～海口	海口游
兰州金城维也纳	兰州金城维也纳酒店
创e家中亚	创e家酒店中亚
黄山木梨硔村客栈	黄山木梨硔村
武汉江汉路地铁站	武汉江汉路
那琴半岛饭店	那琴半岛酒店
福建深度游	福建跟团游
新锒盏温泉度假村	新银盏温泉度假村
杭州到项城	项城到杭州
普吉塔湾棕榈海滩度假村	普吉岛塔夫棕榈海滩度假村
普及车	普吉送机～
无锡市区免费景点	无锡免费玩的景点
青黄岛渔岛	秦皇岛渔岛
普吉岛大象 	普吉岛大象
上海出发哈尔滨跟团游	哈尔滨跟团游上海
巴西签证	巴西商务签证
青城山一日团	青城山一日游小团
哈利波特一日游	哈利波特主题
普吉岛麦考安纳塔拉	普吉岛安纳塔拉迈考度假村
云南香格里拉5日游	云南香格里拉五日游
水裏汤泉	水裏温泉
拒签保险澳大利亚	澳大利亚拒签
德阳火车站附近的酒店	德阳高铁站附近酒店
顺聊湾	巽寮湾
日本签证个人旅游自由行	日本 签证 个人 旅游 自由 行
钟山高尔夫	钟山国际高尔夫
三亚直升	三亚直升机套餐
瑞吉上海	上海瑞吉
无锡翠竹苑大酒店	无锡翠竹苑大酒店 东亭店
无边泳池莫干山	莫干山泳池
泸沽湖环岛包车一日游	泸沽湖一日游包车环湖
郑州出发跟团双人游	郑州出发跟团国内游
杭州千岛湖润和	千岛湖润和
广州一日游包车定制	广州包车一日游
济南山东禧悦东方酒店	禧悦东方酒店（济南高新店）酒店套餐
广州新白云机场	广州白云机场t2
上海维也纳国际酒店上南路店	上海维也纳酒店国家会展中心
银川额济纳	银川 额济纳
北海的酒店民宿	北海民宿
丽江飞行	丽江直升飞机
南温泉公园门票	南温泉 酒店
北京地铁西红门	北京西红门地铁站
云南双人自由行	云南自由行含机票
杭州大酒店泳池	杭州酒店带泳池
成都一日游甘海子	成都甘海子一日游
安顺的速八酒店	安顺速八
机场接机长沙	接机服务长沙黄花机场
崇明东滩民宿	崇明岛名宿
韩国购物返点	韩国返点
莫干山莫颜	莫干山莫颜民宿
惠东虹海湾相心度假酒店	惠州虹海湾相心度假
苏州太苍客运站	苏州太仓客运站
南昆山 酒店	南昆山酒店
常州恐龙园夜场票	常州中华恐龙园门票夜场
清迈spa 	泰国清迈按摩
年夜饭套餐上海	年夜饭上海
七七民宿	七七名宿
北京四合院民宿	北京民宿四合院
丘北普者黑	丘北普者黑湿地公园
迪拜三亚亚特兰蒂斯酒店自助餐	迪拜亚特兰蒂斯酒店自助餐
宝鸡到汉中汽车票	宝鸡到汉中
中山大学附属第一医院东院	中山大学附属肿瘤医院
神龙架滑雪2日	神龙架滑雪两日
四川万州	万州
腾冲驼峰机场酒店	腾冲飞机场附近酒店
凭祥酒店	广西凭祥酒店
北海出发东兴越南一日游芒街	东兴一日游越南芒街一日游
全季酒店浦口	全季浦口
东戴河铂域酒店	东戴河佳兆业铂域
九龙峡漂流	仙龙峡漂流
厦门汉庭优佳	厦门的汉庭酒店
昆明站青旅	昆明青年旅社
南宁儿童乐园	南宁儿童游乐场
五台山云峰山庄	五台山云峰宾馆
天津自驾西安	天津到西安自驾
百色市右江区	百色市右江区火车站附近的酒店
无锡民宿	无锡名宿
杭州西湖景区	杭州 西湖
深圳市观澜湖度假酒店电话	深圳观澜湖度假酒店
天坛医院亚朵	北京天坛医院亚朵酒店
深圳出游	深圳跟团
oyo聚缘酒店	OYO聚缘酒店
七天北京路	七天优品北京路
天津 乐园	天津游乐园
三亚浮生若宿设计民宿（亚龙湾店）	三亚浮生若宿设计民宿
宁波老街	宁波 老 街
缅甸曼德勒翡翠市场	缅甸曼德勒翡翠
杭州滨安路附近的酒店	杭州定安路地铁站附近的酒店
乌镇巷舍	乌镇阳台
长春站的酒店	长春站
杭州火车站接送车	杭州专车接送
重庆江北机场附近住宿	重庆市江北机场
如家五四广场店	如家酒店五四广场
亚庇淘梦岛项目	亚庇淘梦岛
桂林温德姆	桂林温德姆酒店
银基动物王国两大一小	银基动物王国套票
大连青泥8号轻奢公寓	大连青泥8号
大连莲花山门票	大连莲花山观景台门票
新疆旅游定制	新疆定制
青岛海景花园大酒店酒店套餐	青岛海景花园酒店
大明山温泉票	大明山 温泉
岘港流量卡	越南岘港流量卡
南京红山动物国门票	南京红山动物园门票
如家扬州	扬州如家商旅酒店
东南航空	东航航空
文蜂宾馆	文宾宾馆
澳洲旅行团	澳大利亚跟团游
长沙凤凰城跟团游	长沙凤凰城
杭州树人大学	杭州浙江树人大学酒店
洛阳武则天表演	洛阳武则天大剧场
青城山前门票	青城山后山门票
三英温泉度假酒店 	三英当地玩乐
诺维真 喜悦号	喜悦号特价
宁波姜山	宁波姜山酒店
上海 中庚聚龙	上海中庚聚龙
云岩区酒店	云岩区
广州银座酒店	广州市番禺区银座酒店
杭州海洋世界	杭州海洋公园
北京夜景	夜景北京
深圳宝安区民宿	深圳国际会展中心民宿
z hotel	Z hotel 
广州超级草莓音乐节	广州草莓音乐节
香港海洋公园门票餐卷	香港海洋公园门票含餐
乌兰布统两日	乌兰布统草原2日游
飞猪酒店南宁青秀区	南宁青秀新华酒店
海南酒店旅拍	海南 酒店 旅 拍
凤起跷秋涛路布丁酒店	布丁酒店秋涛路
云庭花舍	云庭花舍二号院民宿
艾欧尼亚电竞酒店	艾欧尼亚电竞
香港君怡	香港君怡酒店
香港旁盛酒店	香港盛酒店
海口的别墅	海口度假别墅
西安汉庭鼓楼回民街	西安汉庭钟楼回民街
讷河到天津	天津到讷河
珠海长隆科学酒店自助餐	珠海长隆海洋科学酒店自助晚餐
弗洛伦萨酒店	佛罗伦萨酒店
澳门自由行攻略一天	澳门自由行一天
兰州西北师范大学新校区酒店	兰州西北民族大学附近的酒店
西塘2日	西塘二日游
新郑机场机场大巴	新郑机场大巴
上海橘子酒店川沙	桔子上海川沙
大连 动物	大连动物园门票
大连汤泉	大连温泉
西安蓝溪国际酒店	西安蓝溪国际大厦酒店
莫干山漫旅时光	莫干山漫旅时光精品民宿
厦门鼓	厦门鼓浪屿
广西涠洲岛安格瑞拉花园客栈	涠洲岛安格瑞拉海景民宿
渭南市澄城县	渭南澄城县酒店
乌镇真卿别苑精品客栈	乌镇真卿别苑
修水到赣州	赣州到修水
国立博物馆曼谷	曼谷国立博物馆
抚州万象新城	抚州万达广场酒店
华山壶口瀑布	壶口瀑布华山
纯玩团丽江	丽江纯玩团
泗洪县步行街	泗洪县
广州长隆野生动物园家庭优惠票当天	广州长隆野生动物园家庭优惠票
绍兴东方山水乐园特价	绍兴东方山水乐园
武汉7天连锁酒店小东门	武汉七天连锁酒店江汉路地铁站
新疆青岛办事处	新疆办事处
张掖热气球	张掖 热气球
特价酒店成都	成都特价酒店
重庆至大足石刻	重庆大足
安顺市黄果树瀑布酒店	安顺市黄果树酒店
溧阳南山度假	溧阳南山
宁波美宿高级酒店公寓文化广场	宁波美宿酒店公寓文化广场店
北京到平顶山	平顶山到北京的
乌镇两个90后客栈	乌镇一九九二主题民宿
青岛 钓鱼	青岛海钓
北京格蓝云天酒店	北京云天酒店
挪威缩影卑尔根吕瑟峡湾	挪威缩影卑尔根
预约购火车票	预约火车票
洱海甲壳虫	大理洱海甲壳虫
石家庄跟团洛阳	跟团石家庄
普洱职教中心酒店	普洱汽车站附近酒店
重庆旅行团含机票	重庆自由行三天两晚含机票
恐龙园 温泉	恐龙园温泉
游轮4天	游轮 4 天
蹦极四川	四川蹦极
深圳湾 万丽	深圳湾万丽
合肥银泰城酒店	合肥政务区银泰城附近的酒店
澳门永利皇宫酒店咖啡苑	澳门永利皇宫酒店澳门酒店
海石湾到兰州	海石湾至兰州
西安丈八北路酒店	西安凤城八路酒店
西哈努克送机	西哈努克接送机
机场贵宾休息	机场休息室
诸暨枫桥宾馆	诸暨枫桥镇
长沙欧帝佳精品连锁酒店	长沙欧帝佳精品连锁酒店芙蓉广场地铁站店
蓝田县酒店	蓝田县初级中学
太平洋保险官方	太平洋保险直营
北海道札幌导游	北海道导游
三亚 夜游	三亚游船观光
喆啡酒店上海国际旅游度假区唐镇地铁店	喆啡酒店上海国际旅游度假区酒店
兰花广场酒店	兰花广场
珠海到西安的高铁	西安到珠海火车
广州飞天津	天津飞广州
海南文笔峰景点攻略	海南文笔峰景点自由行
越南 上网	越南wif
上海金科路酒店	上海浦东新区金科路地铁站酒店
天津海底	天津海底世界
签证担保函	担保签证
成都到浙江机票	杭州到成都的机票
东莞到南阳机票	南阳到东莞的机票
杭州床位房	杭州旅店单人间
梅州五华国际大酒店	梅州五华
长隆万圣节夜场票	长隆万圣节门票
上海东方明珠塔旋转餐厅儿童	上海东方明珠塔旋转餐厅午餐
深圳丽枫酒店世界之窗	深圳的丽枫酒店
北京市海淀区阜成路52号	北京市海淀区阜成路附近的酒店
广州钟村	广州 钟 村
集装箱名宿	集装箱民宿
7天优品上海	7天优品酒店上海浦东
天津市南开区人民法院	天津市第一中心医院附近的酒店
合肥宾馆	合肥的宾馆
自驾一日游	自驾 一 日 游
长龙托运行李额购买	行李额购买长龙
冲绳赏鲸	冲绳看鲸鱼
开元森泊 水乐园	开元森泊乐园
海军第一招待所	海军招待所
庐江路合肥省立医院附近的酒店	合肥省立医院庐江路
上海浦东绿地铂丽酒店	上海虹桥绿地铂丽酒店
芭提雅租摩托	芭堤雅摩托
南京体育学院灵谷寺	南京晓庄学院莫愁校区
博霞山庄	博霞山庄酒店
而立酒店	而立
冰雕大世界	冰雕馆
福州长乐南澳沙滩	福州长乐沙滩
涪陵漂流	涪陵武陵峡漂流
青枫白露酒店	清枫白露
迪士尼无限年卡	迪士尼年卡代买
冲浪 潜水	冲浪潜水
马布岛酒店	仙本那马布岛酒店
竹韵酒店	竹韵大酒店
接机福州	福州接送机
万达文华西双版纳别墅	西双版纳万达文华度假酒店
厦门方特梦幻王国和水上乐园	厦门方特水上乐园大门票方特梦幻王国水世界门票厦门水世界票
阳澄湖苏州	阳澄湖
石潭村住宿	石潭村
广州南方医科大学	广州医科大学
广州市白云山	广州市白云区白云山
易佰连锁酒店石家庄	易佰石家庄火车站西广场店
怀柔雁栖镇顶秀美泉小镇	北京怀柔雁栖顶秀美泉小镇
灵山大佛套票	灵山大佛门票
本溪康溪	辽宁本溪康溪
莫干山来野	莫干山 来野
凤凰古城沱江缘民宿	凤凰 古城 沱江 缘 民宿
亳州三中	亳州一中
合肥市如家酒店	合肥市如家
苏州野奢树屋	苏州森林里野奢
成都到乌鲁木齐的飞机票	乌鲁木齐到成都的机票
湘潭友谊广场	湘潭建设路路口附近的酒店
赤峰翁牛特旗酒店	内蒙古赤峰市翁牛特旗
成都凡客宜居设计师酒店	成都凡客宜居设计师公寓九眼桥店
清远百岁温泉酒	清远百岁温泉
赛罕坝国家森林公园	塞罕坝国家森林公园
澳门 流量	澳门流量移动
中山三乡泉眼温泉酒店二人	中山三乡泉眼温泉门票过夜
广东省财经职业技术学校	广东省经济贸易职业技术学校
大阪周游卡	周游卡大阪
普吉岛 半日 	普吉出海半日游
南京至海安	南京到海安
南京融创	南京融创茂
拉萨旅游当地接团	拉萨七日游拼车
上海海昌极地海洋公园门票年卡	上海海昌海洋公园门票年卡
港澳旅行团	港澳跟团游
深圳自驾游	深圳自驾游2天
北海旅游必去的6个景点	北海一日自由行
电瓶车阳朔	阳朔电动车
湍口众安氡温泉度假酒店单人	临安湍口众安氡温泉度假酒店双人
南日岛民宿	南日君悦假日酒店
大阪环球影城一日劵	环球影城大阪一日
密云 漂流	北京密云漂流
westin new yorj	westin new york
保定河北软件职业技术学院酒店	保定河北科技学院
重庆实验外国语学校	重庆教育管理学校
上海地铁线路图	上海地铁图
重庆市渝北区龙塔实验学校	重庆渝北区龙塔实验学校
名古屋富士山周	富士山名古屋
江门一日游江门出发跟团	江门一天游
贵州一日游荔波大小七孔	贵阳荔波小七孔一日游
长隆野生动物园加大马戏	长隆野生动物世界大马戏
腾格尔沙漠穿越	腾格尔沙漠徒步
旅拍 苏州	苏州跟拍
虹桥镇	虹桥镇酒店
美逸达	美利达
长沙芙蓉路湘雅附一酒店	长沙湘雅附一附近酒店
南京G酒店	G酒店南京
三亚到分界洲岛	分界洲岛一日游三亚接送
四川沪州市	四川泸州市
上海迪斯尼门票亲子	上海迪士尼亲子票
德法意签证	法意签证
乌镇西棚景区	乌镇西棚
广东的飞机场	广东有几个机场
张家港无锡火车站	无锡张家港
阳江闸波大角湾	阳江海陵岛闸坡大角湾
贵港西站酒店	贵港高铁站附近的酒店
济南山东建筑大学新校区酒店	济南山东大学中心校区
古北水镇 函谷	古北水镇函谷山庄
浙江湖州安吉	安吉
卡迪亚奈松海滩铂尔曼度假酒店	阿卡迪亚奈松海滩铂尔曼度假酒店
成都雅斯特	成都雅斯特酒店
昆明呈贡大学城酒店	昆明呈贡第七街区酒店
商务车吉隆坡	商务 车 吉隆坡
大理云漫漫	大理云漫漫沧海一墅
南昌免费景点	南昌市区景点
石河子到武汉	武汉到石河子
南麂岛 船票	南麂岛船票
VS SPORTS PARK运动玩乐园	VS SPORT PARK运动玩乐园
三亚亚龙湾万豪团购	三亚亚龙湾万豪
澳门买一送一酒店	澳门特价酒店
信阳罗山县	信阳市罗山县
希尔顿酒店积分北京	北京希尔顿代订
厦航嘉年华酒店	厦航嘉年华
乌镇东西栏	乌镇东西
太平深林公园	太平森林公园
奈良和服	奈良和服租赁
西安艾美精品酒店	西安艾美公寓宾馆
黄金海岸海滩	黄金海岸
4晚普吉岛	普吉岛度假村
仙女山拙雅	武隆仙女山拙雅
粤海公寓	粤海公寓酒店
广州杨箕酒店	广州杨箕地铁站附近酒店
舟山朱家尖附近的名宿	舟山朱家尖附近的民宿
曼谷签证乌鲁木齐	乌鲁木齐曼谷
人妖秀 金东尼	金东尼人妖
昆明春雪国际旅行社	昆明春雪旅行社评价
沙巴美人鱼岛一日游深潜	沙巴一日游美人鱼岛
如家商旅南京江宁上元	如家商旅南京江宁万达广场上元大街店
烟台 旅游	烟台2日游
常州万豪酒店自助餐	常州万豪酒店自助
乌鲁木齐八一中学酒店	乌鲁木齐第十三小学附近的酒店
上海院八间	上海院八间AMAI客栈
万达套房	万达假日套房
天目湖水世界门	天目湖水世界水世界
苏州北到北京	苏州到北京
永利国际酒店	永利国际
青城后山酒店民宿	青城后山民宿
维也纳智好酒店黄山	黄山维也纳国际酒店
jrpass关西广域5	jrpass广域
古龙峡玻璃	古龙 峡 玻璃
峨眉七里坪古镇	峨眉七里坪
如家酒店北京旧宫店	如家旧宫
冰岛浮潜	冰岛海钓
稻城 海螺沟	海螺沟稻城亚丁
巽寮湾喜来登酒店	巽寮湾喜来登
杭州转塘金街美地电影	杭州转塘金街美地
汨罗长沙	长沙汨罗
哈尔滨北北假日	哈尔滨北北
日本环球影城中港通巴士	日本环球影城巴士
海南3天2晚	海南三天
武汉出发二日游京山	武汉二日
长沙五一广场独栋别墅	长沙住宿别墅
lizichengbao	利兹城堡
澳洲 捷星 行李额	澳洲捷星行李
鼓浪屿船票夏鼓码头	鼓浪屿码头船票
南京市河西万达广场附近的酒店	南京河西万达附近的酒店
布丁酒店南京莫愁路	布丁酒店南京路
兰州大酒店	兰州 大 酒店
青杭州春旅社	杭州对象家青年旅社
峨眉山脚下	峨眉
嘉兴南湖区梅湾街附近的酒店	嘉兴南湖区
重庆两江游船票门票	重庆两江游夜景船票
天津北站	天津站附近的酒店
横店出发三日游	横店3日
西安方特	方特西安
迪士尼露营地	迪士尼帐篷
2019泰国跨年	泰国2019年
云南旅游大理丽江雪山	大理丽江玉龙雪山云南旅游5日
莫干山白云山庄	莫干山白云
西城区美食	西城区自助午餐
惠州南	惠州北
接机服务	接 机 服务
热气球，吴	热气球
上海迪士尼官网旗舰店	上海迪士尼旗舰店
尾单天津出发厦门	尾单厦门
万豪国际集团酒店旗舰店	万豪国际集团旗舰
遵义到正安	正安县
对外经贸大学	对外经济贸易大学附近的酒店
永兴花园饭店	永兴花园酒店
广州天河区海景中心	如家广州黄埔大道中天河区政府店
电话卡 韩国	韩国旅游卡
常州3天2晚	常州3日亲子游
阜阳西站	阜阳西站附近的酒店
如家neo无锡	无锡如家精选酒店
承德一中	承德第一中学
旅游保险自由行国内	国内自由行
川西 泸沽湖	四川泸沽湖
檀悦豪生温泉度假村酒店	檀悦豪生度假温泉酒店
广州晓港地铁站	广州晓港
购买行李额济州	济州行李额
景德镇 如家	景德镇人民广场酒店如家
东方明珠门票上海环球金融中心	上海东方明珠门票巅峰票
普吉岛  皮皮	普吉大小皮皮岛
鼓浪屿三丘田码头附近酒店	鼓浪屿附近的酒店
南阳市宛城区	南阳市宛城区公共资源交易中心
张家界旅游纯玩四人小团	张家界旅游3天2晚6人小团
昆明石林门票	云南昆明石林景区门票
青海吃海鲜	青海吃
香格里拉一日游纯玩团丽江出发	丽江到香格里拉一日游
杭州解放路88号酒店	杭州解放路131号
重庆市开州区实验中学	重庆市礼嘉中学校
深圳出租房	深圳租房
惠州潠寮湾门票	惠州巽寮湾门票
贵阳花溪贵大新校区	贵阳花溪大学城酒店
成都的酒店 亚朵	成都亚朵
武昌到岳阳	岳阳到武昌
厦门灵玲国际马戏城套票2大1	厦门灵玲马戏团酒店住宿加门票
上海金陵旅社	上海金陵旅馆
雷州旅游景点	雷州旅游
珠海唐家古镇	珠海市香洲区唐家古镇
西塘住宿 丽枫酒店	丽枫酒店西塘
东莞儿童水上乐园	东莞水上乐园门票
清迈spa rain	清迈spa rarin
咸阳机场空港酒店	咸阳空港酒店
中国移动香港2天流量包	中国移动香港流量包
启东市碧海银沙（启东恒大世纪旅游城）酒店	启东碧海银沙恒大公寓
嘉兴桐乡市濮院酒店	嘉兴桐乡濮院
大同恒山悬空寺云岗石窟	大同云冈石窟悬空寺恒山
上海迪士尼亲自套票	上海迪士尼亲子游
桂林世古东瀑布	桂林古东瀑布
临汾到长治大巴	长治到临汾
金华好玩	金华当地玩乐
上海迪士尼 v烟花	上海迪士尼烟花
烟台开发区高级中学	烟台实验中学
深圳福田区青旅	深圳青旅酒店
三亚市民宿	三亚市的民宿
一嗨租车呼和浩特	呼和浩特租车
汉庭酒店林芝汽车站店	汉庭林芝汽车站酒店
青岛赶海	青岛赶海一日游
天津市区复式民宿	天津民宿loft
杭州美度	杭州美度酒店
北京中国长城	北京 中国 长城
安徽省潜山县天柱山	安庆潜山县天柱山风景区酒店
北京市朝阳区东三环北甲路	北京朝阳北三环东路
京都bus券	京都巴士一日券
珠海澳门	珠海澳门自由行
泰州溱湖国家湿地公园温泉	泰州溱湖国家湿地公园碧桂园
维也纳临安	杭州维也纳智好酒店（临安店）酒店套餐
美国流量包	美国电话卡15
青岛dm巧克力公寓	青岛巧克力公寓酒店
天津市民广场酒店	天津市民广场 地铁站 酒店
巴厘岛  跟拍	巴厘岛婚纱照
台湾当地阿里山	台湾阿里山
青岛长岛别墅	长岛别墅
武夷山演出	武夷山景区门票
九寨沟四姑娘	九寨沟四姑娘山
苏州旺山旅馆	苏州旺山酒店
上海 迪士尼 酒店	上海迪士尼附近酒店
苏州观前街附近	苏州 观前街
湖北民族大学附近旅店	湖北工业大学附近的酒店
恩平游泳池	恩平泳道酒店
宜春7天优品酒店	宜春7天连锁酒店
马来西亚卡怕莱水上	马来西亚卡帕莱水上
泛海	泛海国际
桔子水晶酒店青岛	桔子水晶酒店 青岛
长春到辽源	辽源到长春
蹦极北京	北京 蹦极
郑州中原万达酒店	郑州中原万达广场酒店
十堰奥斯特精选酒店	十堰奥斯特酒店
丽枫酒店广州长寿东路	麗枫酒店·广州白云大道北地铁站永泰店
接车清迈	清迈接送车
深圳湾口岸巴士	深圳湾巴士
临沂温泉住宿	温泉  临沂
天津公路客运西站	天津站附近的酒店
惠州巽寮湾酒店	惠州市巽寮湾酒店
敦煌星月客栈	敦煌敦月客栈
南昌华东交通大学南区酒店	江西南昌华东交通大学附近酒店
漳州网红景点	漳州的当地玩乐
上海闵行区泰虹路酒店	上海闵行区漕宝路附近的酒店
璞素酒店	璞素设计师酒店
亚朵酒店象山	象山亚朵酒店
尧珈凡舍	尧珈凡舍悬崖民宿
拉萨4日游	拉萨旅游四日游
漂流浙西	浙北漂流
如家酒店钟楼	如家 钟楼
迪士尼通行证	迪士尼vip免排队快速通行证
千岛湖 度假	千岛湖度假
苏州济州岛汤泉	济州岛汤泉
杭州杭行路希尔顿欢朋酒店	杭州奥体中心希尔顿欢朋酒店
儿童平衡车	儿童平衡车比赛
天目山自然保护区	天目山风景区
新加坡移动wifi	新加坡wifi租赁
如家酒店neo上海火车站	如家neo上海火车站南广场
拉萨一日游圣象天门	拉萨圣象天门一日游
境外旅行险亚洲d	境外旅行险亚洲
海棠湾酒店喜来登高端	三亚海棠湾喜来登度假酒店
威海华联	威海华联大酒店
巴厘岛宝格丽酒店下午茶漂浮	巴厘岛宝格丽酒店下午茶
仁川机场胶囊酒店	仁川天空机场酒店
黄龙门票	黄龙风景区门票
宁波杭州湾方特水上	宁波杭州湾水上
wifi租赁 意大利	意大利WiFi
西安2号线北客站附近的酒店	西安2号线会展中心附近的酒店
诸城丽景逸林酒店	诸城丽景商务客房
江苏盱眙酒店	盱眙车站附近酒店
斐阿塞拜疆	阿塞拜疆
如家睿柏云酒店五一南	如家睿柏云酒店
天水南到兰州	天水南到兰州西
桔子水晶大理洱海公园	桔子水晶大理洱海公园酒店
重庆渝北民宿	重庆渝北区民宿
民宿 西岭雪山	西岭雪山民宿
锦江之星厦门会展中心酒店	厦门的锦江之星酒店
海天大酒店 昆明	海天酒店昆明
蛇口到香港机场	蛇口码头到香港机场
古尔沟华美达温泉	古尔沟华美达温泉度假酒店
无锡寄畅园	无锡寄畅园门票
漳浦诚隆商务宾馆	漳浦谊隆商务宾馆
黄岩酒店	黄岩的酒店
青岛锦江之星李	青岛锦江之星
天俊	天俊酒店
无锡喜来登酒店	无锡喜来登
易佰连锁大柏	易佰连锁旅店上海大柏树地铁站店
郑州中原国际博览中心	郑州中原区酒店
惠州轰趴别墅	惠州别墅轰趴
郑州麻将酒店	郑州麻将
千岛湖诺富特	千岛湖诺富特酒店
厦门3天	厦门 三天
彬县汽车站	彬县酒店
从化区温泉镇	从化温泉酒店
获嘉县酒店	获嘉县住宿
三亚豪幕斯度假公寓	三亚豪幕斯
西安中贸广场民宿	西安民宿北站
阳朔县西街	阳朔县西街酒店
大理双廊樱花贝儿海景客栈	大理双廊镇樱花贝儿海景客栈
中南百草园景区旗舰店	中南百草园门票
深圳机场贵宾厅	深圳机场vip贵宾休息室
敦煌大话西游国际沙漠露营	敦煌沙漠露营体验
海南三亚5日4晚半自助	海南三亚五天四晚自由行
徐州贾汪区酒店	徐州贾汪区
济南方特的门票通票	济南方特一日通票
南宁站附近的酒店	南宁东站酒店
兵马俑华清宫	华清宫兵马俑一日游
阳朔龙脊梯田2日游	阳朔龙脊梯田二日
神农架酒店套票	神农架
北海当地玩乐免门票	北海的当地玩乐
长春大街	长春开运街
南方航空 优惠券	南方航空券
川崎的民宿	日本川崎民宿
宁波奉化职教中心酒店	宁波奉化汽车站
宁波到绍兴	绍兴到宁波
贵阳7天连锁酒店	贵阳北站酒店七天连锁酒店
上海迪士尼乐园家庭	上海迪士尼儿童
海晏海华快捷酒店	海晏华兴酒店
近港澳澳大桥酒店	港澳大桥酒店
流量马来西亚聊天	流量马来西亚
泸沽湖集美.度若无云客栈	泸沽湖集美度若无云
雪乡长白山	中国雪乡长白山
九寨沟跟团游南京出发	九寨沟跟团游杭州出发
山屿海安吉	安吉山屿海
武汉儿童医院香港路	武汉市儿童医院香港路的酒店
普吉出发一日游	普吉浮潜
乌鲁木齐去云南	乌鲁木齐云南
大理喜洲古镇h	大理喜洲古镇
渔村小筑	渔村客栈
拉萨5天4晚	拉萨 5 天 4 晚
广州融创雪世界 自带板	广州融创雪世界初级
中科院植物园一日游	中科植物园一日游
龙岩维也纳	龙岩维也纳国际酒店
接送机丽江	丽江接机
创e家酒店 台州黄岩店	创e家酒店（台州黄岩店）
云梦山上	云梦山
合肥市罍街酒店	合肥市罍街名小吃广场酒店
沈阳北到盘锦	盘锦到沈阳
北京三日游。	北京跟团游3天2晚
北欧五国游	北欧4国
深圳玛雅水乐园	深圳欢乐谷玛雅水上乐园
广州长隆国际马戏城	广州市长隆国际大马戏酒店
合肥嘉士顿国际酒店	合肥嘉仕顿国际酒店
jd铂豪酒店	jd铂豪
南昌市南昌三中青山湖罗家校区酒店	南昌三中东湖区
自由行贵州	贵州旅游自由行
丽江松云壹号酒店	丽江束河松云壹号酒店
拉斯维加斯魔术	拉斯维加斯魔术秀
统景门票	统景 门票
水峪村	水峪民俗村
大阪淀粉屋	大阪淀屋
下川岛品海假日酒店	下川岛品海
郑州港区汉庭	郑州汉庭
丽江到香格里拉车票	丽江到香格里拉
广州长隆丽枫酒店	广州长隆丽枫
楚雄南站	楚雄站
成都黄龙两日游	黄龙二日
杭州2日游上海出发	杭州上海两日游
上海邯郸路酒店	上海延长路地铁站酒店
达尔文 凯瑟琳	凯瑟琳达尔文
重慶住宿	重庆我住过的酒店
西安陕师大长安校区家庭	西安陕师大长安校区
香港迪士尼2日门票单成人	香港迪士尼一日门票2
山东政法学院附近的酒店	山东轻工职业学院附近的酒店
春季游	春季旅游
北京自由行3天2晚酒店+机票	北京3天2晚自由行
马尼拉机场wing酒店	马尼拉尼科尔机场酒店
湖州龙之梦海洋世界	湖州 龙之梦动物世界大酒店
全季酒店上海黄浦	上海黄浦区全季酒店
济南万达广场酒店	济南万达广场
海口市第十四中学	海口市第十中学
港澳游意外险	港澳旅游意外险
重庆到萧山	萧山到重庆
丽江民宿古城区	丽江民宿
合肥海洋世界附近的酒店	合肥广电中心
广州从化温泉山庄度假别墅	广州从化温泉别墅套
青岛黄岛区金沙滩民宿两居	青岛银沙滩黄岛区民宿
西宁火车站附近的如家快捷酒店	西宁市如家精选酒店
三亚飞机票	海南三亚飞机票
汕天市	汕头市
广州到东莞汽车票	东莞到广州汽车票
成都泸沽湖	泸沽湖成都
迪士尼电竞酒店	电竞酒店迪士尼
云南大理丽江6天5晚跟团旅游	云南大理丽江6天5晚跟团
去西安旅游	到西安旅游
珠海新海利	珠海市新海利
南昌网红	南昌网红店
中汇	中汇酒店
郑州到长乐	长乐到郑州
美国电话卡 长期	美国电话卡 国内
王权 普吉	普吉岛王权
南澳青旅	南澳岛青旅
西安汉唐驿青年旅社	西安汉唐驿国际青年旅舍
莫干山净园	湖州莫干山净园麓舍客栈
桃花岛酒店	桃花岛住宿
歌华	歌华酒店
荆州方特东方神画门票儿童票	荆州方特东方神画门票亲子
千岛湖阳光	千岛湖阳光酒店
丰城到上海	上海到丰城
吉林省内景点	吉林省旅游景点
保定理工学院附近宾馆	保定师范附属学校
如家 河坊街	如家精选酒店河坊街
上海崇明长兴岛附近度假酒店	崇明长兴岛
北京水立方门票	北京水立方水上乐园
武汉丽枫酒店	武汉丽枫
香港澳门珠海六日游	香港澳门六日
巴州库尔勒市煜程	库尔勒煜程
长沙疯狂的麦咭 	长沙 疯狂的麦咭
肇庆火车站附近的酒店	肇庆站
德国号码卡	流量卡德国
哈尔滨的宾馆	哈尔滨宾馆
南京兵器博物馆	博物馆南京
都江堰青城山二王庙一日游	都江堰青城山一日都江堰
维多利亚酒店（合肥黄山路中科大店）	维多利亚酒店合肥
威海国际展览中心	威海北站附近的酒店
昆明长水机场到昆明站	长水机场到昆明南站
杭州至香港飞	杭州飞香港
厦门火车站附近玩	厦门火车站
广州夜游珠江	广州珠江夜游大沙头
长沙五一广场家庭房	长沙家庭房
三峡游轮华夏神女	华夏神女三峡
香港 游轮	香港公海
天津到武清区	天津武清
上海闵行区锦江之星文井	上海锦江之星闵行
张家界武陵源风景名胜区酒店	张家界武陵源酒店
维也纳国际酒店郴州	郴州维也纳酒店
花间堂北京	北京祥和花间堂农家院
塔卡寺	塔尔寺
澳門機票買一送一	澳门 机票买一送一
焦作云台山景区紫金	焦作云台山景区
安徽合肥市新华电脑专修学院	合肥安徽新华电脑专修学院酒店
丽江去稻城亚丁	丽江到稻城亚丁旅游团
牡丹江到南昌	南昌到牡丹江
上海市欢乐谷门票	上海欢乐谷的门票
银川市金凤万达广场商圈酒店	银川金凤万达A座
关山牧场自由行	关山牧场二日游
温馨岛蝶来酒店	温馨岛蝶来
台湾澎湖湾	澎湖岛
常州市亚朵酒店	亚朵 常州
厦门鼓浪屿门票东	厦门鼓浪屿门票
横山区的酒店	横山区
桐庐爬山	桐庐一日游
宜昌香山花园	宜昌香山花园酒店
珠海长隆海洋王国两人套票	珠海长隆海洋王国
永州江永酒店	湖南永州江永县
沈阳市胸科医院	沈阳肿瘤医院
昆山溪地	昆山溪地酒店 
岳阳会展中心	岳阳一中
锦江之星奉贤	锦江之星品尚奉贤
柬埔寨跟团游5天	柬埔寨5天跟团纯玩
新郑至海口	新郑到海口
三亚三晚自由行	三亚自由行6晚
新疆旅游北疆拼车	新疆南北疆大环线拼车
格鲁吉亚美食	格鲁吉亚自助午餐
青岛方特快速通行证	青岛方特梦幻王国直通车
上海迪士尼玩具总动员酒店3人	上海迪士尼玩具总动员酒店套餐提前入园
西宁宾馆	西宁火车站附近宾馆
重庆涪陵北站	重庆涪陵区附近的酒店
婺源的主要景点	婺源县旅游景点
杭州四星民宿	杭州四星住宿
临安湍口众安氡温泉度假酒店车票	临安湍口众安氡温泉度假酒店
天目湖水	天目湖御水
白公馆渣仔洞	白公馆渣滓洞
南充北站酒店	南充北站
深圳金光华广场探鱼	深圳金光华广场
稻城亚丁旅游5日游	稻城亚丁旅游五日游
日本五年	日本三年
绍兴开元 曼居酒店迪荡新城店	开元曼居 绍兴迪荡世茂广场店
港澳通行证续签湖北	湖北港澳签注代办
重庆欢乐谷的门票年票	重庆欢乐谷年票
苏州电竞房	苏州电竞房酒店
飞猪dishini	飞猪迪士尼
泉州纺织服装职业学院	泉州师范学院
山东招远龙湖大酒店	招远龙湖大酒店
武汉光谷尚品	光谷尚品
新疆火车票	新疆 火车
丽江泸沽湖酒店	丽江市泸沽湖酒店
南岳衡山住宿	南岳衡山酒店
广西北海涠洲岛船票	北海涠洲岛船票
成都情趣主题酒店	情趣主题酒店成都电动床
南澳度假酒店	南澳海景别墅
拉萨旅游2天	拉萨2日游
西双版纳景洪市泼水广场	西双版纳景洪市泼水广场酒店
苏州园林拙政园附近民宿	苏州住宿拙政园附近民宿
成都东站 电竞酒店	成都电竞酒店
丽江大东巴酒店玉碧峰	丽江玉碧峰酒店
怡莱精品酒店常州	常州怡莱酒店
定制游 桂林	桂林定制旅游
冷水滩区政府	冷水滩区的酒店
印尼电话卡tsel	印尼telkomsel电话卡
宜昌均瑶广场附近酒店	宜昌均瑶广场附近住宿
香港贵宾室	香港贵宾厅
杭州乐园联票	杭州乐园门票成人票
嵊州市长乐镇	嵊州长乐镇
广州柏曼酒店新市黄石西路店	柏曼酒店广州南
南疆喀什	新疆南疆喀什
吉安天虹广场	吉安天虹购物中心酒店
迪士尼 全季	迪士尼全季
揭阳有什么好玩的	揭阳的景点
万宁石梅湾艾美	万宁石梅湾艾美度假酒店
厦门中山路步行街附近复士楼	厦门中山路步行街
三亚莫言莫语酒店	三亚莫言莫语民宿
清远阳山温泉	清远阳山县第一峰
蓬莱长岛潜游	蓬莱长岛旅游
全季恐龙园	全季 恐龙园
广东增称	广东增城
厦门方水上乐园	厦门方特水上乐园
西安高新万达	西安万达广场
成都宽窄巷子希尔顿酒店	成都中心希尔顿酒店
成都到南溪的汽车票	南溪到成都
武汉纺织大学阳光校区酒店	武汉纺织大学阳光校区
广州澳门往返车票	广州到澳门来回车票
民宿麻将	民宿麻将房
美国随身wifi租赁漫游超人美西	美国随身wifi租赁漫游超人
西安出发自驾游成都	西安至成都自驾游
渥太华饥岩速8酒店	渥太华 饥 岩 速 8 酒店
吴川有什么好玩的地方	吴川当地玩乐
上海市罗亚尔国际酒店	上海罗亚尔国际酒店
陕西太白县民宿	太白县的民宿
武汉射击场	武汉射击馆
鼓浪屿无垠酒店	鼓浪屿酒店
租房三亚	三亚租房长期
成都华西二院锦江院区酒店	成都华西第二医院附近的酒店
成都出发至西藏包车游	成都去西藏包车
巴厘岛lvpai	巴厘岛旅拍
邮轮 天津	国内邮轮天津
境内旅游意外保险	旅行意外保险国内
南京义鸟小商品城	南京义乌小商品城
马来西亚大学	马来西亚理科大学
香港旺角吃	旺角香港
巴黎迪士尼乐园一日两园	巴黎迪士尼乐园一日
温州苍南鱼寮	温州苍南鱼寮沙滩
太原市山西省财政税务专科学校酒店	太原山西省经贸学校酒店
丽水景宁畲族自治县风景区	丽水景宁畲族之窗
贵阳一日漩	贵阳一日游
组团旅游	跟团
南通苏建希尔顿	南通希尔顿
重庆的民宿家庭房可做饭	重庆的民宿家庭房整租
深圳南山Gitigo	深圳南山citigo
重庆万州机场	重庆万州五桥机场附近的酒店
金鹏航空公司	祥鹏航空公司
林芝团	林芝当地团
华山景区	华山游
拖板鞋 青旅	铂泊客·拖板鞋社交旅行酒店（春熙路太古里店）
哈尔滨中央大街附近的酒店空中花园	哈尔滨中央大街花园酒店
上海海昌海洋公园旅拍	上海海昌旅拍
地铁4号线	地铁 4 号 线
西安到兵马俑	西安兵马俑往返车票
芜湖美宿概念酒店 停车场	芜湖美宿概念酒店
太行明珠快捷酒店	太行明珠酒店
长白山柏悦别墅	长白山柏悦
上海扬子饭店	上海杨子饭店
乔波滑雪绍兴	绍兴乔波
猫儿山门票加酒店住宿	酒店门票猫儿山
大阪环球影城标准快速单项	大阪环球影城快速票标准
hello 客栈	Hello客栈
酒店景德镇	江西景德镇酒店
海拉尔 	海拉尔游玩
南宁站到百色	南宁东到百色
成都北站汽车站	成都火车东站附近酒店
汪汪队之立大功	汪汪队立大功
北碚公园	北碚
黑龙江到重庆	哈尔滨到重庆
影秀商务酒店义乌	义乌王府商务酒店
洲际集团酒店自助	洲际集团酒店
东莞出发跟团三天桂林游	东莞出发桂林旅游3天2晚
龙潭河温泉	龙潭河温泉酒店
木一优质酒店	木一优质
梅花洲水上乐园	梅花洲景区
宜宾巡场镇	宜宾巡场酒店
曼谷包车 	曼谷包车
桂林漓江四星船	桂林漓江三星船
合肥高速·滨湖时代广场酒店	合肥滨湖高速时代广场
西双版纳门票套票	西双版纳门票
深圳j海边酒店	深圳酒店海边
贵阳东哈尔滨	贵阳哈尔滨
深圳包车过关去深圳	深圳过关深圳包车
迪斯尼攻略	迪士尼攻略
三亚奈斯民宿	三亚奈斯nice
太白山私汤温泉	太白山温泉私汤
泰顺徐岙底古村落附近的酒店	泰顺徐岙底古村落
南通职业大学	南通师范高等专科学校新校区
哈尔滨市内游乐园	哈尔滨室内游乐园
九江江西庐山颐朵云尚	庐山颐朵云尚酒店
海洋馆 杭州	杭州极地世界
宁致	宁致酒店
云酒店花园路南京	云酒店南京
哈尔滨市第十一中学校	哈尔滨市第四十九中学校
艾阁智汇酒店	艾阁智
石圳村	长圳村
泉州福建崇武西沙湾假日酒店海景房	泉州崇武西沙湾假日酒店
龙岩市第九中学	龙岩市第一医院
沈阳机场头等舱休息室	沈阳机场休息室
电竞酒店温州	温州住加电竞酒店
爱琴海宾馆	爱琴海主题宾馆
义乌租车旅游	义乌租车
代办港澳通行证	全国港澳通行证签注
深圳回南昌	深圳到江西南昌
上海火电站恒玉宾馆	上海火车站恒玉宾馆
顺德区华盖路	顺德 华盖路
青岛崂山风景区东入口	青岛崂山风景区
射阳旅游	射阳景点
An house 芽庄	芽庄 house
澳门4流量	澳门流量4g
帝豪国际大酒店	帝豪国际
郑州美豪诺富特会展中心酒店	郑州美豪诺富特酒店
上海迪士尼1日门票 儿童	上海迪士尼门票1日儿童票
沈阳宜家	沈阳宜家精品酒店太原街店
丽江泸沽湖三天两晚纯玩	丽江泸沽湖三日游
麓谷水上乐园门票	水上乐园门票
足疗spa	spa套餐
重庆碧津公园附近的酒店	重庆碧津酒店
鹭岛观光旅游1线	鹭岛观光
上海茨城	茨城
悦椿温泉 腾冲	腾冲悦椿
佛山金腾大酒店	佛山岭南明珠体育馆金腾大酒店
石井酒店	石井
洛阳最近滑雪场	洛阳最近滑雪
乌鲁木齐iu酒店	iu酒店乌鲁木齐
杭州萧山机场巴士	杭州萧山国际机场大巴
佛山简素公寓（兆阳O立方店）	佛山简素公寓
欧洲申根保险	申根国家保险
如家 上海赤峰	上海如家赤峰路
郑州卡莱顿	郑州 卡莱顿
惠州。温泉	惠州龙门
郑州河南检察职业学院酒店	郑州河南建筑职业技术学院酒店
涠洲岛潮海民宿	北海涠洲岛一席民宿
方株洲特梦幻王国	方特乐园梦幻王国株洲
厦门海沧希尔顿酒店	厦门希尔顿
八一广场/南昌火车站附近的酒店	南昌八一广场/南昌火车站酒店
扬州经济开发区亚朵	扬州亚朵
雨润中央公馆	雨润中央公馆行政酒店
日本东京大阪自由行机票酒店尾单	日本东京大阪自由行机票酒店北京
苏州金凤凰温泉度假村酒店	苏州金凤凰温泉度假村
珠海御温泉按摩	珠海御温泉庙会大餐套票按摩
珠海新海利	珠海新海利大酒店
洛阳龙门附近酒店	洛阳龙门附近的酒店
漳州天下广场酒店	漳州三中
内蒙古大草原	内蒙古旅游跟团跟团游
公交卡  南昌	南昌一卡通
珠海长隆海洋王国二大二小套餐	珠海长隆海洋王国套餐
北京环球影城票	环球影城门票北京
万达 主题乐园	万达乐园安徽
厦门大学附属心血管病医院	厦门医学院附近的酒店
斯米兰船宿 3号	斯米兰船宿3
全季杏林湾	全季酒店杏林湾
滨海宾馆	滨海假日宾馆
青岛万达主题	青岛万达东方影都水乐园
福州跟团	福州跟团游
深圳莲花北站	深圳莲花北地铁站
马尔代夫 库拉玛蒂	库拉马提岛
武夷山大红袍演出	武夷山三联票大红袍
广州7天连锁酒店区zhuang	广州7天连锁酒店区庄
惠州双月湾景点	惠州双月湾景区
如家潍坊新华路北宫街店	如家-潍坊新华路胜利东街市府广场店
上海海上小喔人民广场店	上海海上小喔南京东路店
珠海长隆两日一夜	珠海长隆2天一夜
挖色租车	挖色租电动车
三清山门票	三清山一日
广州南沙港	广州 南沙 港
鹤壁市兰苑中学	鹤壁市汽车客运总站
上海齐鲁万怡	上海浦东齐鲁万怡大酒店
莱卡精品酒店 深圳东门店	莱卡酒店 深圳
三亚湾海棠湾	三亚 海棠湾
贵州10人小团纯玩	贵州纯玩小团
永泰嵩口	永泰 嵩口
峨眉山温泉滑雪	峨眉山温泉滑雪场
mc密室逃脱	mc真人密室逃脱
深圳市肿瘤医院附近的酒店	深圳市儿童医院附近的酒店
重庆到成都东的火车票	重庆北到成都东火车票
金鹏国际酒店	金鹏酒店
电子社保卡	电子医保卡
吉普岛成人表演秀	普吉成人表演秀
中信旅行	中信国旅
黄水康养	黄水康养酒店
香港迪士尼快捷票	迪士尼票香港
安吉县云上草原附近酒店	安吉县云上草原附近的酒店
济南市中级人民法院附近的酒店	济南市第一中学
普吉包船	普吉岛包船出海
兰卡威浮潜	兰卡威潜水
青岛海情大酒店B座	青岛海情大酒店b
流量	换流量
泡泡屋广西	广西 泡泡屋
赛里木湖一日游 环湖	赛里木湖一日
无锡到成都动车	无锡到成都
山东财经大学舜耕校区酒店	山东财经大学舜耕校区
长沙贺龙摩天轮票	长沙摩天轮
厦门世贸双子塔水晶之恋海景公寓	厦门世茂双子塔卡曼海景公寓
九寨沟墨石公园	墨石公园九寨沟
杨朔名宿	阳朔民宿
广州火车站青旅	广州民俗
安曼北京	安曼 北京
成都武侯寺博物馆	成都武侯祠博物馆
太原全季酒店	太原 全季
昆明缓慢山谷客栈	昆明缓慢山谷
合肥到洛阳	洛阳到合肥
遂宁 酒店	遂宁的酒店
上海浦三路锦记酒店	上海浦三路锦季酒店
大理彩云之南	大理五彩云
翔顺金水台	翔顺金水台小镇酒店
杭州汉庭武林门	杭州西湖武林广场汉庭酒店
手机充值	电信充值
广州万佳服装批发市场附近	广州东服装批发市场附近酒店
迪斯尼年卡 上海	上海迪士尼度假区
衢州友好酒店	衢州友好饭店酒店
泰国 手机卡 	泰国卡上网
溧阳市人民医院	溧阳市茶亭医院
桔子水晶外滩	桔子水晶北外滩
济南园博圆	济南园博园
北洛湾	北洛湾风景区
韩国t?money	韩国 t-money
拉斯维加斯 大峡谷 一日	拉斯维加斯峡谷
天津津门逸境文化酒店	天津津门逸境
普吉 按摩	普吉兰花
首尔飞长春	长春到首尔往返机票
金轨	金轨酒店
公交卡意大利	意大利交通
南京汤山私家温泉名宿	南京汤山一号温泉名宿
上海西郊假日	上海西郊假日酒店
上海酒店麻将套房	上海麻将
日本 无线wifi	大阪移动wifi
中环至半山扶梯	中环半山
黄山松谷庵	黄山松谷
泰顺民宿	泰顺酒店
浙江附近旅游	浙江省内游
长沙7天优品酒店	长沙七天优品酒店
广州五山地铁站	广州五山科技广场
北海到海口轮船票	北海到海口汽车轮渡船票
伊犁安平大酒店	伊犁大酒店
从昆明去丽江车票	丽江到昆明汽车票
玉龙雪山香格里拉	玉龙 雪山 香格里拉
北京机场vip贵宾休息室	北京机场贵宾休息室
长沙柏锐 美麓智能民宿	长沙柏锐美麓智能民宿
美泉温泉	美泉温泉酒店
上海到乌鲁木齐飞机票	上海到乌鲁木齐机票
七浦路锦江之星	锦江之星秀浦路
丽水冒险岛附近酒店	浙江丽水冒险岛水世界附近酒店
梅园酒店厦门	厦门梅园大酒店
临安湍口众安氡温泉度假酒店套餐	临安湍口众安氡温泉酒店
荔枝酒店公寓	荔枝假日公寓
澳门沨竹自助餐午餐	澳门渢竹自助餐
马尔代夫水屋攻略	马尔代夫水屋自由行
九寨沟豪生	九寨沟豪生酒店
重度沟竹里会馆	重渡沟竹里会馆
杭州的宾馆	杭州宾馆
雅悦酒店北京	雅悦酒店（北京崇文门店）
北海出发一日游	北海一日
瑞吉北京	北京 瑞吉
佛山佰德广场酒店	佛山北滘商业广场酒店
上海儿童乐园酒店	上海儿童酒店
济南市行知小学	济南市友谊小学附近的酒店
清远西沙	清远沙
上海崇明岛民宿别墅	崇明岛民宿别墅
芭堤雅 泰拳	芭堤雅泰拳
西安跟团纯玩	西安纯玩跟团
海友上海外滩南京东路酒店	海友上海外滩南京路步行街酒店
普陀山跟团无锡	普陀山三日游无锡出发
南京青奥体育公园体育馆酒店	南京青奥体育公园
西欧自由行	西欧 自由 行
三亚亚龙湾沙滩门票	三亚亚龙湾周边景点
重庆小米熊儿童医院	重庆医科大学附属儿童医院
古北水镇大酒单人	古北水镇大酒
俄罗斯旅游保险 俄罗斯公司	俄罗斯旅游保险
上海市嘉定区人民法院	上海市嘉定区中心医院医技楼
香港迪斯尼回广州	广州香港迪斯尼
榆林市酒店	榆林市第七中学
哈尔滨太平国际机场汉庭酒店	汉庭机场路店哈尔滨
伊卡	伊卡酒店
邮轮日本wifi	日本邮轮wifi
乐山特色民宿	乐山的民宿
杭州东栅	杭州 东 栅
舟山嵊泗海景大酒店	嵊泗嵊山大酒店
崂山附近	崂山住宿
阿坝州滑雪	阿坝滑雪
汉庭上海张江园区广兰路地铁站酒店	上海汉庭酒店广兰路地铁站
扬州3日游自由行	扬州三天两夜游
吉林市第十二中学	吉林市实验中学
皇家加勒比邮轮	皇家加勒比国际游轮
马尔代夫一价全包拖	马尔代夫一价全包拖尾
门密码锁	密码门锁
弥勒太平湖森林木屋酒店酒店套餐	弥勒太平湖森林木屋酒店
青岛市青岛海昌极地海洋世界	青岛海昌极地海洋世界 三馆
攀枝花上恒大酒店	攀枝花恒大
文成滑雪场	文成滑雪
短租房西安一个月	西安短租房一周
本溪大冰沟国家地质森林公园	本溪大冰沟门票
广州去贵州	广州到贵州高铁票
安微宏村	宏村景区内酒店
崇礼太舞滑雪小镇 附近的酒店	崇礼太舞滑雪小镇住宿
郑州站前时尚酒店	郑州上街汽车站
冲绳签证单次	冲绳签证
丽江市丽江古城	丽江 古城
艾欧	艾欧轻奢酒店
上海虹桥绿地博瑞	上海虹桥绿地
阜阳二中	阜阳四中
维也纳酒店仙胡大道	维也纳酒店仙葫大道
福清宏路酒店	福清宏路车站
海口民宿别墅	海口民宿家庭套房
蒙古国工作签证	蒙古国签证
芜湖艾唯尚品	艾唯尚品酒店芜湖
大余漂流	大余丫山漂流
昆明高原明珠酒店商务楼	昆明高原明珠酒店昌宏路店
青岛方特梦幻王国门票年卡	青岛方特梦幻王国年卡
北京亲子游泳馆	游泳馆北京
国际火车票莫斯科	坐上火车去莫斯科
哈尔滨和颐	哈尔滨中央大街和颐酒店
成都月友	成都月友连锁酒店九眼桥店
河源凯里亚德酒店	凯里亚德酒店河源
皇包车日本大阪机场	日本接送机东京羽田接机大阪接送机成田机场北海道冲绳接送机
旅游拼团济南	济南旅游团
旅拍云南	云南旅游网红旅拍
朵兰精品酒店	朵兰酒店
珠海长隆海洋王国往返车	珠海长隆海洋王国大巴
大理古城有情岁月	大理古城岁月
南京苹果酒店	南京苹果水晶酒店
三亚呀诺达热带雨林门票电瓶车	三亚呀诺达热带雨林轻松游车票
贵州豪华游	贵州自助游
福州龙祥	福州龙祥大酒店晋安区
弥勒室内温泉	弥勒温泉
卡丁车惠州	惠州越野卡丁车
长水机场休息室	长水机场vip贵宾休息室
杭州西溪湿地喜来登酒店	杭州西溪喜来登度假大酒店
杭州德胜瑞莱克斯大酒店	瑞莱克斯大酒店杭州
广州从化温泉温馨别墅	广州从化温泉泳池别墅
西蔵自驾游	西藏自驾游单程
巴黎歌剧院演出票	巴黎 歌剧院
珠海出发港澳珠大桥观光	珠海 出发 港澳 珠 大桥 观光
越南签证提前	越南签签证
惠州万科双月湾欢乐度假公寓	惠州万科双月湾二期亲子房
黄山 民宿	黄山名宿
上海到青岛飞机票	上海到青岛机票
长沙湖南师范大学理学院酒店	长沙湖南行政学院酒店
台州古城墙	台州府城文化旅游区
大阪难波	難波
杭州蹦床主题公园	杭州蹦床乐园
汉庭酒店昆明	昆明的汉庭酒店
河南省周口市淮阳县	河南省周口市淮阳
涵谷山庄	函谷山庄
Y Hotel	Y hotel
宝鸡公园路附近的酒店	宝鸡新建路的酒店
广州民宿4人	广州偶来民宿
普宁火车站	普宁站
酒店+天津方特	天津方特自由行
长白山晚点宜必思	长白山宜必思3晚
深圳北到萍乡	深圳北到萍乡北
大小洞天跟拍	大小洞天 旅拍
长沙 天心区	长沙 雨花区
便宜居济南	济南便宜居酒店
如家精品	如家酒店
惠州大亚湾霞涌泡泡海民宿	惠州大亚湾霞涌泡泡海微时光
天然气灶	煤气
上海杭州两日游	杭州上海二日
jrpass北陆高山	高山北陆五日周游券
飞沙滩门票	飞沙滩旅游区
惠州龙门铁泉黄金汤	惠州龙门铁泉温泉门票
厦门鼓浪屿自由行重庆出发	厦门鼓浪屿重庆
西安曲江一中	西安曲江新区酒店
石家庄精英中学	石家庄精英中学附近的酒店
深圳维也纳酒店深圳湾	深圳 维也纳 酒店 深圳 湾
蓟县县城农家院	农家院蓟县
马戏 自助餐	马戏酒店餐
尖山站	尖山火车站
成都都江堰青城山2日游纯玩	青城山都江堰两日游
兰州三十三中	兰州八中
苏州天颐温泉度假区	苏州天颐温泉 别墅
三亚私人旅行定制小团	三亚当地定制小包团
温都水城门票	温都水城水上乐园
随州西游记公园附近住宿	随州西游记公园住宿
绵阳市培城区	绵阳市博雅学校
上海迪士尼，乌镇	乌镇迪士尼
西双版纳石林一带	西双版纳石林
惠州雙月灣	惠州，双月湾
澳门liuliangbao	澳门流量包
贵阳出发深圳一日游	深圳一日
长春高新智	长春高新
済州岛	济州
长春八中	长春五十二中
惠州双月湾檀悦豪生度假酒店复	惠州双月湾檀悦豪生度假酒店自驾游
防城港白浪滩风景区附近的酒店	防城港白浪滩海景酒店
西安跟团游	西安当地游跟团
长沙民宿公寓套房	长沙五一广场民宿家庭套房
邢台公寓	邢台中北世纪城公寓
上海到日本邮轮	邮轮游日本
南航航班	南航A380
佳木斯旅店	佳木斯宾馆
全季酒店 外滩	全季上海外滩
日式床垫	日式 床垫
万达水乐园上	水乐园万达
西沙群岛自由行	西沙群岛跟团游
泰州水世界	泰州水上乐园
香港悦品度假酒店 屯门	香港悦品度假酒店(屯門)
惠州金海湾喜来登度假酒店t	惠州金海湾嘉华度假酒店
42B Ly Thuong Kiet Street	44b ly thuong kiet street
三清山金沙索道附近的酒店	三清山金沙索道附近住宿
自贡汽车站的酒店	自贡市汽车客运总站
海南省西沙	海南西沙
湖北民族大学科技学院附近宾馆	湖北生物科技职业学院酒店
亚朵酒店公寓	亚朵公寓
香港自由行4天3晚机票	香港自由行含机票酒店
丽江到虎跳峡拼车	丽江虎跳峡直通车
菏泽到	菏泽拼车
杭州一日行	杭州一日
金玲宾馆	金玲商务宾馆
昕雅图酒店	昕雅图
济州岛 	济州岛的
天津到重庆旅游攻略	天津到重庆一日
金川跟团游	金川 跟 团 游
日本北海道摄影跟拍	北海道旅拍
西安市旅游包车	西安旅游用车
法国尼斯摩纳哥一日游	摩纳哥一日游
上饶灵山索道下	上饶灵山索道
山东济南章丘	山东章丘
西安至西宁	西安到西宁高铁
重庆北站到重庆西	重庆西站到重庆北站
上海市静安区如家酒店	上海如家酒店静安寺
青岛权品七汤	青岛权品七汤温泉度假酒店
抚顺海洋馆	海洋馆抚顺
宁海花源里民宿	宁海花源里
南京金陵学院	南京金陵高等职业技术学校
上海迪士尼 餐券	上海迪士尼餐券
杭州东到襄阳东	襄阳到杭州东
欧利维亚	欧利维亚酒店
河源九连山原始森林度假村	河源九连山温泉度假村
跨省接送温州	温州接送
青海湖帐篷出租	青海湖帐篷
西宁三江原饭店	西宁三江源饭店
太原 宁武	宁武太原
少林寺小龙精品大酒店	少林寺小龙大酒店
惠州双月湾出海深潜	惠州双月湾出海浮潜
普陀山慈航	舟山普陀山慈航大酒店
肇庆维多利酒店	肇庆新利坚酒店
北京莲花池公园	北京莲花池公园门票
海南到贵州	海南到贵阳
香格里拉 既下山	香格里拉既下山
泸沽湖次第花开客栈	丽江泸沽湖次第花开客栈
广州长隆万圣夜	广州长隆欢乐世界晚上
杭州如家商旅河坊店	杭州河坊街如家
深圳到广州北	广州南到深圳
南戴河民宿可做饭	民宿 南戴河
厦门安防科技职业学院	厦门城市职业学院
日本蜜月旅行双人自由行	蜜月旅行日本
富翔	富翔大酒店
三亚海棠湾五星级酒店	三亚五星级酒店
拜城县酒店	拜城县的宾馆
武汉洪山区南李路酒店	武汉洪山广场附近酒店
富林精选	富林
济南机场接送	接机服务济南
温州学苑连锁宾馆	学苑连锁酒店(温州大学城店)
云南小包团纯玩	云南旅游小包团
武汉天河机场	武汉市天河机场酒店
柏曼酒店 珠海拱北口岸店	珠海柏曼
全季文殊院	全季文殊
拜登公寓·杭州印店	拜登公寓杭州印店
嬉游 青岛	青岛 嬉游
泳池千岛湖	千岛湖 泳池
杭州度美酒店 	杭州市度美酒店
北京丰台区	丰台区酒店
华夏城夜场	华夏城演出
甘肃火车票	甘肃火车
济州岛半自由行	旅行团济州岛
江北国际机场酒店	江北机场t2附近酒店
全季永丰路	全季酒店永丰路店
海口海鲜美食	海口海鲜自助午餐
松花湖3晚	松花湖度假区旗舰店
深圳欢乐谷快速通道票	深圳欢乐谷通票
邯巢酒店	邯巢连锁酒店
德宏陇川	德宏陇川酒店
烟台金色沙滩	烟台金沙滩海滨公园
成都短租公寓	成都 短租公寓
如家精选重庆解放碑	如家重庆解放碑
瑯玡阁	琅琊阁
汕头市鸵岛宾馆	汕头市鮀岛宾馆
甘肃定西	甘肃定西市
大连富丽华酒店	大连富丽华
杭州富阳蓝钻国际城堡酒店	富阳蓝钻国际城堡酒店
上海迪士尼乐园儿童票210	上海迪士尼度假区
都江堰民宿南桥	都江堰附近民宿
上海迪士尼乐园门票尊享票	上海迪士尼乐园门票豪华票
海口到北海船票	北海到海口的船票
云南旅游 5天	云南旅游5天四晚
上海亲子酒店中心	上海亲子酒店
安琪儿	安琪儿酒店
浴缸公寓	公寓浴缸
长白山三日游 	长白山三天
潍坊怡家客房	潍坊怡家客房五洲店
南宁市竹溪路28号	南宁市长堽路酒店
珀荟	珀荟酒店
上海周边游功略	周边游上海
上海市长宁区凯旋路	上海市长宁区虹桥路
芒果主题公寓	芒果精品公寓
合肥安医大第一附属医院	合肥安医大一附院
三亚约拍	三亚旅游跟拍
钦州蓝海湾商务酒店	钦州金海湾酒店
长恨歌演出票	长恨歌票
三明尤溪侠天下	三明尤溪侠天下套票
绍兴旅游团	绍兴旅行
兰州酒店麻将房	兰州市汽车南站酒店
千岛湖民宿 	千岛湖附近名宿
厦门出发北京5日游纯玩团	北京五日游纯玩厦门出发
克塞斯别墅	普吉岛阿克塞斯别墅度假酒店
湖州动物园门票	湖州野生动物园
上海名宿逸巢	上海民宿逸巢
海南国旅	海南友恒国旅
南京夫子庙秦淮河畔酒店	南京秦淮区夫子庙秦淮河酒店
三亚君澜鹿回头国宾馆下午茶	三亚君澜鹿回头国宾馆
丽枫酒店 武汉长港路店	麗枫酒店·武汉江汉路
奥体亚朵	奥体亚朵s
广州长隆野生动物世界门票团票	广州长隆野生动物世界单人票
行李额购买长龙	行李额购买吉祥
银川大阅城	银川大阅城酒店
新疆跟团游广东出发广之旅	新疆跟团游广之旅
喀什包车游	喀什拼车
许昌市许昌学院酒店	许昌市许昌电气职业学院酒店
开封tl酒店式民宿鼓楼广场店	tl酒店式民宿开封
速八酒店上海徐家汇店	速8酒店上海徐家汇店
普吉岛蓝海度假村	普吉岛蓝海度假酒店
广西十里画廊	广西 十 里 画廊
日本大阪京都奈良迪士尼	日本迪士尼京都大阪
佛山火车站附近酒店	佛山西站附近的酒店
成都九寨沟黄龙5日游纯玩	成都九寨沟黄龙五日游
卢沟湖且慢	泸沽湖且曼
杭州滨江区江虹路	杭州滨江区长江南路
柳林县的酒店	柳林县酒店
北海门票	北海景点
重庆旅游报团	重庆团游
洛阳市白马寺酒店	洛阳白马寺附近宾馆
斑马旅游法国南部	斑马旅游法国
湖州莫干山亚朵	德清莫干山亚朵酒店
上海儿童主题酒店	上海亲子主题酒店
长,人艮	长,人民
云海碱泉养生馆	云海碱泉养生公馆
青城道温泉酒店	青城道酒店
长沙民五一广场	长沙五一广场
广州长隆野生动物世界酒店套票	广州 长隆 野生 动物 世界 酒店 套票
阆中附近景区	阆中门票
长沙凡宿酒店	长沙凡宿公寓
汉庭酒店花园路	汉庭优佳花园路
长沙五一广场附近	长沙五一广场附近的酒店
太原凯宾斯基自助	太原凯宾斯基早餐
日照山字河机场	日照山字河国际机场
厦门伴栋house民宿	厦门民宿整栋
百城	百程
充电器苹果6	充电器苹果
大理洱海月弯酒店	大理洱海之月酒店
双月湾惠州	惠州双月湾宾馆
湖州太湖龙之梦动物园自驾车	湖州太湖龙之梦动物园车票
大理云南建设学校附近的酒店	大理护理职业学院附近的酒店
阜阳市颍州区万达广场	阜阳颍州区
拉市海骑马	拉市海骑马门票
济南威海北	威海济南
吴哥窟一日	吴哥窟一天
莫干山云卷	莫干云卷
希尔顿 义乌	义乌希尔顿欢朋
珠海家庭套房	珠海套房
泰国机票往返自由行	泰国机票往返
奥特曼。	奥特曼
杭州浙一医院附近酒店	杭州浙一医院
景德镇大酒店	景德镇国贸大酒店
夏门接机	厦门接送服务
长安一偶	长安一隅
北京旅游慕田峪八达岭长城	北京八达岭长城2日游
厦门四日游，深圳出发	厦门 四 日 游 ， 深圳 出发
南宁跟团	南宁跟团游
Im设计师酒店	m设计师酒店
乌鲁木齐地接	乌鲁木齐接站
西溪国家湿地公园周家村	西溪湿地周家村
湖南省博物馆门票预约	湖南省博物馆门票
蒂芙尼人妖秀芭堤雅	芭堤雅蒂芬妮
广州广办旅行社	广州广东旅行社
美术馆	美术 馆
贵阳北到佛山西	贵阳到佛山西
合肥祥源区	合肥经贸旅游学校附近的酒店
杭州锦江之星酒店离西湖最近	杭州西湖酒店锦江之星
龙阳路地铁站酒店	龙阳路地铁站附近的酒店
洞头出海捕鱼	洞头捕鱼
丽江佖屋酒店	丽江佖屋
河内到南宁火车	南宁到河内的火车票
北京长城金山岭	北京金山岭长城
广州至拉萨	拉萨广州
情侣度假酒店	度假酒店情侣
成都 度假村	成都度假村
境外流量 香港 	境外香港流量
摩登s酒店 成都天府广场店	成都摩登s酒店中坝
迪士尼门票礼遇服务	迪士尼门票尊享
贵宾室虹桥	虹桥贵宾
江西6日跟团游	江西6日游纯玩团
上海波特曼丽思卡尔顿酒店	上海波特曼丽思卡尔顿
兰州出发去甘南两日游	兰州甘肃二日
保利银滩	保利银滩酒店
北京八达岭长城十三陵	北京八达岭长城十三陵一日游
水博园大酒店	水博园酒店
峨眉山一日游 高铁	峨眉山一日
香格里拉园区	香格里拉客运站
温州的旅馆	温州住宿
昭通市	昭通市的酒店
长沙酒店维也纳	长沙维也纳国际酒店
上海迪士尼乐园快速通行证尊	上海迪士尼乐园vip快速通行证
星梦邮轮	星梦游轮探索梦号
广州莲花山岭南佳园度假村	广州莲花山岭南佳园度假酒店
为什么买不了火车票	为什么不能买火车票
杭州旅游攻略	杭州旅游自由行
海南深度游	海南旅游
新疆哈什旅游	新疆二日游
开封到濮阳的火车票	开封到濮阳
澳门沊仔酒店	澳门凼仔(Taipa)酒店
黑龙江农业职业技术学院	黑龙江工程学院
海口罗盟精品酒店	海口羅盟酒店（日月广场店）
昆明市游乐场	昆明游乐园
贵阳青岩古镇大门票	贵阳市青岩古镇景点
山之家	山 之 家
汽车出租	租车。
曼谷空呖玛龙水上市场	曼谷空玛荣水上市场
春节上海迪士尼门票	春节上海迪士尼
驻马店中医院	驻马店第一高级中学
开封官驿	开封清明上河园内官驿酒店
成都名亚朵	成都亚朵
南宁明秀路(地铁站)酒店	南宁市明秀东路附近的酒店
烧烤杭州	杭州烧烤
自驾三日游	自驾 三 日 游
惠州龙门香溪堡	惠州龙门香溪堡门票
安吉晓舍	安吉吉舍民宿
北海去德天瀑布	北海德天瀑布
中国政法大学国际交流中心如何？	中国政法大学国际交流中心
梵净山附近景点	梵净山
租车去西藏	西藏租车 
滨安路	滨安路650号
平顺县阱底村酒店	平顺县印象井底酒店
日本三年签附属	日本三年签
山西大同北岳恒山	大同恒山
阳朔 Iq84	阳朔 1q84
武如家精选酒店徐东	武汉如家精选酒店徐东
三里屯民宿	民宿三里屯
苏州无锡游三日	苏州无锡三日旅游
天恒山滑雪	天恒山滑雪场
广州中山市	广州中山
句容龙锦宾馆	句容龙锦快捷酒店
青甘四天	青甘四日游
北京自然博物馆	北京自然博物馆门票
舟山玫瑰	舟山玫瑰园酒店
上海接机到苏州	接机苏州
新疆乌鲁木齐接送机用车	乌鲁木齐接送机
银川兴庆区中房富力城	银川公寓
长沙青竹湖	长沙 青竹湖
青海湖回西宁	西宁青海湖
白银的酒店	白银第十中学
绵阳师范学院北校区	绵阳师范学院磨家校区附近酒店
全季芙蓉中路酒店	全季芙蓉中路
上海银七星室内滑雪场	上海银七星滑雪场
张家界索道	张家界国家森林公园索道
雪乡包车	雪乡 包车
烟台到上海飞机票	烟台到上海往返
济南九如山瀑布群风景区一日游	济南九如山一日游
海南省定安县	海南 省 定安 县
黄金海岸假日公寓	黄金海岸度假公寓
北京 天津七日游	北京七日
日本wifi机场自取 当天	日本wifi 机场自取
如家棱角湖	如家菱角湖
岭南佳园连锁酒店沿	岭南佳园连锁酒店广州沿江东路店
比斯特购物村一日游	英国比斯特购物村一日游
广州香港直通巴士	广州香港往返巴士
梧州旺城酒店	梧州旺城广场
汉庭太原火车站酒店	汉庭酒店太原
全季深圳北	全季酒店深圳
三亚的亚龙湾酒店	三亚亚龙湾的酒店
浙江工商大学	浙江工业大学
鹰潭北	江西鹰潭北
九口门水上长城	九门口水上长城
宜昌到凤凰古城	宜昌到凤凰
旅行 意外险	旅游险
花水湾温泉酒店套餐	花水湾温泉度假酒店
苏州市吴中区太湖湿地公园	苏州太湖湖滨国家湿地公园
北海银滩旅游度假区别墅	北海银滩别墅群
拼车大理	大理到
广州火车站附近美食	广州火车站附近自助午餐
普吉岛环岛一日游查龙	普吉岛一日游查龙
武汉市武汉汉口火车站酒店	武汉汉口火车站地铁二号线酒店
日本东京	日本 东京
智慧城	智慧新城附近酒店
上海t2	上海虹桥t2
jiuwu	九五
珠海海泉湾海洋温泉门票双人	珠海海泉湾温泉门票
开元名庭 千岛湖	千岛湖开元名庭
普吉岛naiharn	普吉岛奈涵海滩
塘沽航母公园	天津塘沽航母公园
嫩江路地铁站	嫩江路8号
重庆市徐悲鸿中学	重庆市实验中学
全季酒店宁国路	全季宁国路
惠州双月湾亲子酒店	惠州双月湾亲子沙滩酒店
卡帕欢乐谷	欢乐谷卡
福州上三路学生街派柏云酒店	福州学生街师范大学派柏.云酒店
珠海飞机场酒店	珠海机场
景德镇青旅	景德镇青年旅社
上海市上海立信会计金融学院浦东校区酒店	上海市上海工商职业技术学院酒店
台州客运南站	台州站
济南索菲特银座大酒店	济南索菲特银座大饭店
泰国涛岛潜水	泰国涛岛自由潜
上海科技馆附近的酒店	上海科技馆酒店
境外港澳旅游保险	旅游保险港澳
上海马戏城 票	上海马戏票
杭州如家驿居酒店学院路地铁站	杭州如家驿居酒店
青岛海底世界	青岛海洋极地世界
翡冷翠鸢民宿	翡冷翠民宿
箬寮原始林	箬寮原始林景区
衡山西小吃街	山西小吃街
南沙群岛邮轮	南沙群岛游轮
长岛林海公园门票	长岛林海门票
南通野生动物园酒店	南通森林野生动物园附近酒店
重庆4人亲子游特色体验	重庆亲子游免费
独克宗酒店	独克宗附近的酒店
拉萨一日游接送	拉萨一日游
迪士尼 年卡	迪士尼乐园年卡
扬州瘦西湖景区门票2大1小	扬州瘦西湖景区门票
希尔顿欢朋酒店西安	西安希尔顿酒店
慢生活民宿	慢 生活 民宿
希尔德	希尔德酒店
张掖天德假日酒店	张掖天德大酒店
贵阳 租车	贵阳租车自驾游
凤凰古城芙蓉镇	凤凰古城
西安悦椿温泉酒店自助	西安悦椿温泉酒店
gongwangf	恭王府
从乌鲁木齐出发	乌鲁木齐旅游
成都市中西医结合医院	成都市第三人民医院附近的酒店
榆林到延安	榆林到西安
合肥肥西县附近的酒店	合肥肥西酒店
西班牙签证上海送签	西班牙签证上海
黄山溪谷山庄	黄山森林木屋
新郑到菏泽	菏泽到郑州
南京 名宿	南京温泉民宿
重庆蹦床乐园	重庆蹦床馆
佛山四叶草公寓 佰德广场店	佛山四叶草公寓智汇
日喀则4日游	日喀则四日游
西安鼓楼酒店四星级	西安酒店四星级
常州嬉戏谷夜公园门票	常州嬉戏谷门票
宁波到贵阳的高铁	宁波到贵阳高铁
西安博物馆门票珍	西安自然博物馆门票
舟山的民宿	舟山东港民宿
普吉岛kadingche	普吉岛卡丁车
郎悦轻奢公寓	朗悦轻奢公寓
长隆预约	长隆免排队
鄂尔多斯飞机场	鄂尔多斯空港酒店机场店
日照渔家乐日月居	日照日月居渔家宾馆
西安华山镇	西安华山
北京日式	北京 日式
迪拜海底酒店	迪拜水下酒店
杭州余杭区良诸	杭州良诸
南宁市东盟商务区酒店	南宁市第一中学五象校区附近的酒店
江西婺源篁岭景区民宿	江西婺源篁岭民宿
武汉光谷大道附近酒店	武汉光谷广场附近的酒店
锦江之星酒店西安解放路店	锦江之星西安解放路第四医院大差市地铁站酒店（原西安解放路店）西安市第四医院附近
岳麓山日出	岳麓山攻略
酒店式公寓 西安	西安公寓式酒店
仁里宁墅	仁里美宿·宁墅
汉溪长隆水上乐园夜场	汉溪长隆水上乐园
昆明周边游玩	昆明周边
青岛海昌极地海洋世界四馆年卡	青岛海昌极地海洋公园双人年卡
郑州科学大道信息工程大学	郑州技术学院
珠海长隆一天大马戏套票	珠海长隆大马戏当天票
张家口北站火车站附近的酒店	张家口站附近的酒店
三亚亲子名宿	三亚民宿别墅独栋
汉庭上地	汉庭酒店北京上地店
重庆自由行三天两晚含机票	重庆自由行三天
珠海长隆企鹅酒店2天1晚单人	珠海长隆二日两日企鹅酒店
香港移动wifi广州高铁自取	香港wifi广州高铁自取
揭阳望天湖门票	揭阳望天湖旅游度假区
四川商务职业学院	四川城市职业学院
宁波罗蒙环球乐园酒店加门票	宁波罗蒙环球乐园门票酒店
龙出没穿越漂流	龙出没漂流
苏州山塘古街	苏州山塘街
德阳到哪里好玩	德阳当地玩乐
50元优惠券	5元优惠券
芸笙酒店	芸笙
不丹跟团游	不丹旅行团
七叶枫酒店	七叶枫
敦煌旅游又见敦煌演出门票	敦煌演出哪个值得一看
武当山神农架5日游	神农架武当山五日游
毛里求斯接机	毛里求斯送机
玉林市主题酒店玉林	玉林酒店
武宣汽车站	武宣的酒店
珠海长隆剧院大马戏龙秀门票	珠海长隆国际大马戏门票一等票
酒店入住飞猪	飞猪酒店会员
马代魔鬼富士岛	马代富士岛
广州他她会公寓酒店广州南站	广州南站他她会公寓
珠海熹龙	珠海熹龙商务酒店
昆明成都	云南成都
台州 出海	台州海钓
马尔代夫蓝色美人蕉	马尔代夫蓝色美人蕉岛一价全包
广州动漫	广州动漫展
随州泡温泉	随州温泉
广州市南方医科大学珠江医院酒店	广州南方医科大学珠江医院酒店
杭州费尔曼酒店	杭州费尔曼铂金大酒店
美的鹭湖森林度假区湖光鹭影	美的鹭湖森林
希腊旅游跟团游	希腊跟团游
清远希尔顿朋克酒店	清远希尔顿酒店
深圳宝安机场t3附近的酒店	深圳宝安国际机场酒店
重庆华宇温德姆至尊豪廷	重庆华宇温德姆至尊豪廷大酒店
重庆大隐壹号	重庆解放碑大隐壹号
梵高艺术馆	梵高美术馆
上海青浦区宾馆	上海宾馆附近
南山竹海 小火车	南山竹海火车
杭州上城区民宿	杭州南站民宿
鼓浪屿全季酒店	厦门鼓浪屿全季
湛江普罗旺斯	湛江普罗旺斯酒店
济南卡尔的萌宠庄园	济南卡尔萌宠
新加坡辣螃蟹	新加坡螃蟹
杭州山水宾馆	杭州西湖区教工路山水宾馆
西安大唐芙蓉园歌舞表演	西安大唐芙蓉园表演
荔园快捷酒店 天津站店	荔园快捷酒店（天津站店）
横滨名宿	横滨民宿
金华自由行	金华2日游
巴厘岛ow潜水证考证	巴厘岛潜水考证
京都御所预约	京都御所
江山耕读水上屋度假	江山耕读农场水上屋度假区
上海迪士尼四人票	上海迪士尼3人票
三亚雅居乐莱佛士	三亚海南雅居乐莱佛士酒店
运城到淄博	济南到运城
济南泉城广场店附近的酒店	济南市泉城广场酒店
珠海维帝客	维帝客酒店公寓珠海拱北口岸
石家庄北辰广场酒店	石家庄中铁商务广场酒店
腾冲艺墅里温泉假日酒	花筑·腾冲艺墅里温泉假日酒店
长春我行我宿酒店公寓	长春我行我宿公寓（吉大南校店）
广州到贵阳	广东到贵阳
衢州九华漂流	衢州 漂流
天水到庆阳	天水到庆阳的大巴
嘉定海洋公园	嘉定海洋馆
杭州西湖下午游	杭州西湖游
三亚万延主题酒店	三亚万廷主题酒店
无线网港澳	港澳wifi漫游超人
wifi东京取	wifi东京
华滨国际大酒店	华滨国际酒店
广州塔小蛮腰附近民宿	广州塔民宿
保利精品酒店	保利酒店
天水好玩的地方	天水当地玩乐
杭州开元森泊度假酒店湖州	杭州开元森泊度假酒店旗舰
成都 希尔顿	成都希尔顿
汕尾保利金町湾希尔顿逸林酒店	汕尾保利希尔顿逸林酒店 
三亚亚龙湾丽兹卡尔顿	亚龙湾丽兹卡尔顿
合肥度假村	合肥度假酒店
全季酒店龙翔桥	龙翔桥附近全季酒店
廊坊东方大学城附近的酒店	廊坊东方大学城酒店
户外徒步一天成都	成都周边一日游徒步
大别山南武当滑雪场	大别山南武当滑雪场门票
杭州如家酒店火车东站新丰路290号	杭州如家酒店火车东站新风路290号
云南游玩路线	云南旅游路线
天台山石梁飞瀑联票	浙江天台山石梁飞瀑
香港澳门自由行4天3晚纯玩	香港澳门4日3晚跟团游
香港雅高酒店集团	香港雅高酒店
福州的温泉	福州 温泉
温泉阜新	阜新
南昌顺外路附近的酒店	南昌顺外路
大梅沙芭提雅	大梅沙芭提雅酒店
近海洋公园的香港酒店	香港酒店海洋公园
北京t2机场候	北京t2机场
杭州亲子主题酒店	杭州亲子酒店
青海草原蒙古包	青海蒙古包
黄腾峡玻璃桥	黄腾峡门票
运城足疗店	足疗运城
阿坝藏族羌族自治州四姑娘山酒店	阿坝藏族羌族自治州四姑娘山镇
温泉银川	温泉小镇银川
威海荣成洲际假日广场酒店	威海荣成市
赤峰新城宾馆	赤峰汽车站附近宾馆
福州百翔家海滨	福州佰翔家海滨
西安交大第一附属医院附近宾馆	西安交大第一附属医院
洞头民俗	洞头
clybmed	clibmed
拒马河十五渡	十渡拒马河漂流
邯郸太行山	东太行邯郸
广州创融乐园门票	广州融创体育世界 乐园
泰国曼谷一日游团	泰国 曼谷 一 日 游 团
广州长隆香江大酒店早餐	广州长隆香江酒店早餐
宜必思西安北二环明光路酒店	宜必思酒店西安北站店
丽江三亚	云南三亚丽江游
上海戏剧学院莲花路校区	上海音乐学院附近酒店
厦门度假村	厦门 度假 村
太原平阳路汉庭酒店	太原汉庭快捷酒店
厦门 跟拍	厦门旅拍个人跟拍
昆明曲靖	曲靖昆明
印秋设计师酒店	印秋设计
泉州欧乐堡	泉州欧乐堡水上乐园
北京周边骑行群	北京周边骑行
泸沽湖女神湾	丽江泸沽湖女神湾
交通宾馆	交通宾馆酒店
杭州到上海动车	上海到杭州的汽车票
話費	充值话费
全季酒店沪青平	全季沪青平
曼谷点芭提雅拼车	芭提雅拼车曼谷
双廊到泸沽湖拼车	泸沽湖到双廊
乌镇西栅酒吧	乌镇酒吧
杭州出发千岛湖	千岛湖上海出发
涵月	涵 月
南街村旅游	南街村门票
下龙湾吉婆岛	吉婆岛
夜游两江·两江游船票+专享船方直通车往返码头（两人立减45元/极速出票/	【可定当天】重庆两江游夜景游船票金碧游艇朝天门朝天宫游轮门票
丽江古镇到玉龙雪山	丽江古城到玉龙雪山专线车
普洱倚象山半山酒店	普洱倚象山营地暨半山酒店
薄荷岛自由潜	薄荷岛 潜水
沙坪坝好玩的地方	沙坪坝门票
桐庐丘泉居	桐庐岳泉居民宿
云南旅游精品小团	云南精品小团
涠洲岛鹿港花园小栈	涠洲岛鹿港
日本东京 交通卡	东京地铁卡
六盘水盘州	六盘水盘县
佛山高明美的鹭湖探索王国	佛山高明美的鹭湖水世界门票
南宁夏朵酒店	南宁夏朵
苏州新城花园丽呈华廷	苏州新城花园丽呈华庭酒店
水上乐园开封	开封水上乐园
普吉岛租车接送	普吉岛租车
重庆站	重庆北站
嬉戏谷完美水世界儿童	嬉戏谷完美水世界
长窿广州	长隆广州
西安交大附近民宿	西安北站附近民宿
皇岗口岸附近酒店	皇岗口岸
郑州水床	郑州水床情趣酒店
顺德嘉信候机楼	顺德候机楼
沧州市政府	沧州市开发区
樱桃沟风景区	樱桃沟一日
义乌租车	租车 义乌
布城 气球	布城热气球
南京新街口汉庭酒店	南京新街口 汉庭
成都市锦江区东大街	 成都锦江区
福州纯玩跟新疆团游	新疆跟团游纯玩团
豪庭廷万佳酒店	豪庭万佳酒店
西安情趣酒店	西安情侣情趣酒店
雷迪森早餐	雷迪森自助晚餐
中山紫杉国际酒店公寓	中山紫杉国际酒店
凯澜酒店(哈尔滨中央大街店)	凯澜酒店 哈尔滨中央大街店
美国新泽西包车	美国新泽西
北京环球影城 优先购票	北京环球影城抽奖
宁波象山海边大酒店	宁波象山海边酒店
九洞天门票	九 洞天 门票
翰海之冠	海之冠
邯郸市如家快捷酒店丛台路	邯郸市如家快捷酒店
广州市景点	广州市景区
亚庇	亚庇的当地玩乐
黄腾峡漂流票价	黄腾峡漂流套票
成都一成一府	成都一成一府精品酒店
北海北部湾广场附近的酒店	北海海城区
周庄一日游苏州出发	苏州一日游周庄
海南6天5晚	海南6天
较场尾当地玩乐	较场尾二日
如家武汉江汉路步行街江滩店	如家酒店江汉路
扬州瘦西湖温泉度假村别墅	扬州瘦西湖温泉度假村
孝感东站到汉口站	汉口到孝感东站
厦门周边酒店	厦门附近
连云港高铁站	连云港火车站
无锡灵山拈花湾拈花客栈	无锡拈花湾 拈花客栈
西安七十一中	西安七十一中学
秦淮区大行宫玉泉宾馆	秦淮大行宫宾馆
宜昌五一广场酒店	宜昌万达广场附近的酒店
长沙到俄罗斯	长沙俄罗斯
迈凯斯酒店	迈凯斯
六盘水市三中	六盘水市第三实验中学
上海迪士尼门票全季酒店	上海全季酒店迪士尼店
珠海长隆企鹅酒店	珠海长隆企鹅酒店家庭房3人
厦门大学附属中山医院	厦门中山医院
上海市上海交通大学徐汇校区酒店	上海徐汇区上师大附近酒店
肇庆的公寓	肇庆 公寓
阳朔谷雅酒店	阳朔谷雅
青海是莫高窟	青海湖莫高窟
三亚 柏悦酒店	三亚 柏悦
佛山市三水万达商圈酒店	佛山市三水万达酒店
乌鲁木齐地窝堡机场附近住宿	乌鲁木齐地窝堡机场附近的酒店
广东天露山门票	广东天露山旅游
红璞礼遇酒店 桂林万达店	桂林红璞礼遇
台北 洛基大饭店	台北西门大饭店
清迈 	清迈旅游攻略
天津洗浴过夜	天津过夜洗浴中心
武汉周边二日游自驾	武汉周边自驾两日游
成都 亲子	亲子成都游
篱枫酒店	枫酒店
dazhoudao	大洲岛
希腊 	希腊 跟团
深圳野生	深圳 野生
西双版纳原始森林公园演出	西双版纳原始森林公园
才村海景苑客栈	才村海景
芜湖安徽师范大学	芜湖安徽工程大学站附近的酒店
深圳码头	深圳机场福永码头船票
和平饭店晚餐	和平饭店餐厅
望京 酒店	望京酒店
西安中国唐苑门票	西安中国唐苑一日
爱弥尔亲子乐园	爱弥尔亲子
拉萨丽江	云南拉萨
北海艺术设计学院附近酒店	北海一中附近的酒店
重庆到武隆汽车票	重庆北到武隆
普吉岛风车观景台	观景台普吉岛
南昆山区温泉度假村	南昆山溫泉
蓝梦岛学潜水	蓝梦岛潜水
钦州。	广西钦州
淮安市	淮安市中心
重庆出发成都一日	成都一日重庆
三亚湾游船门票	三亚湾船票门票
海鲜自助成都	成都海鲜自助餐
杭州带浴缸酒店	杭州浴缸酒店
青岛市著旅游景点	青岛市区旅游景点
孟姜女苗	孟姜女庙
彭州的酒店	彭州
民宿 上海	上海，民宿
肇庆东站	肇庆站附近的酒店
东方山水山之国	东方山水 山之王国
武汉江汉路汉正街酒店如家	武汉市江汉路步行街如家酒店
大理腾冲西双版纳	云南腾冲版纳
上海虹口广灵二路附近的酒店	上海虹口区广灵二路附近的酒店
常州淹城野生动物园喜来登	常州淹城野生动物园酒店加门票0
新疆双飞8天跟团北京出发	新疆跟团游8天五飞
RAMADA首爾	ramada 首尔
米莱酒店式公寓	米莱酒店公寓
临汾洪洞大酒店	山西临汾洪洞县
沙巴kamaspa	沙巴kama
秦始皇兵马俑博物馆车	秦始皇兵马俑博物馆门票
湛江霞山的酒店	湛江市霞山
马甸桥南	马甸桥酒店
南京禄口机场贵宾	南京机场贵宾
乐山民宿投影	乐山民宿市中区附近
山东电子职业技术学院附近酒店	山东工程职业技术大学
桂林漓水人家客栈	桂林漓水人家景区
新郑到长春	郑州到长春的高铁
济南龙湖天街	济南经四路万达广场附近的酒店
东莞东莞东火车站附近酒店	东莞东火车站
武汉的酒店钟点房洪山广场	武汉酒店洪山广场
乐山嘉定坊禅驿	乐山禅驿·嘉定院子客栈
ow普吉岛	普吉潜水考证
三亚海棠湾丽湖酒店	三亚海棠湾丽湖度假酒店
拉萨到长春	长春到拉萨
迪拜奇迹花园门票	奇迹花园迪拜
上海迪斯尼迪士尼乐园附近	上海迪士尼门票一日
泸沽湖且慢度假酒店	泸沽湖度假酒店
北海札幌道滑雪	滑雪北海道
丝绸之路 文化酒店	丝绸之路中华文化酒店
上海直飞澳门机票	上海澳门往返机票
安福武功山帐篷	吉安安福武功山景区帐篷
达州宣汉	达州宣汉大酒店
顺德华侨城欢乐海岸水上乐园	顺德华侨城欢乐海岸套票
大连像日酒店式公寓	大连海上假日酒店式公寓
南宁哪里比较好玩	南宁有啥好玩的
夏门科技馆	厦门科技馆
广州住星精品主题酒店	广州住星酒店北京路店
重庆市一日游纯玩	重庆市一日游
北京一日游纯玩圆明园	北京一日游圆明园天坛
厦门市中山路商圈酒店	厦门市厦门中山路酒店
上海南京东路人民广场和颐酒店	上海和颐南京路步行街
廊坊市第七中学	廊坊市第二中学附近酒店
花间里影院公寓王家湾	花间里影院公寓王家湾摩尔城
九华山公交车	九华山大巴车
玻利维亚跟团游	玻利维亚
郴州五岭广场	郴州文化路
如家邹城矿建东路兖矿总部店	邹城如家
三亚保利玫瑰酒店	三亚保利玫瑰
涵田温泉酒店	涵田温泉
邯郸赵王欢乐谷	邯郸赵王欢乐城
台北漫游超人	台北 漫游 超人
株洲e时代酒店	株洲中车时代
野人谷跟团游	野人谷景区
南京新街口和颐酒店	南京和颐酒店新街口
保定市莲池区职教中心	保定市职业技术教育中心
 神农架	神农架全景
巴黎包车一日	巴黎地陪导游
木兰草原附近酒店	木兰草原住宿
厦门七尚	七尚酒店厦门
广州一日攻略	广州 一 日 攻略
翡翠湖大酒店	翡翠湖酒店
南京有哪些著名景区	南京必去景点有门票
顺德欢乐海岸plus水上乐园	顺德欢乐海岸plus水上
新加坡 保险	新加坡保险
湖州野界度假村	湖州野界度假
泰国摩托	泰国摩托车租赁
满洲里酒加景	酒景满洲里
北戴河假日酒店	北戴河中意假日酒店
银基附近的酒店	银基附近酒店
南宁邕武路酒店	南宁明秀东路酒店
启东恒大海上威尼斯酒店式公寓	启东恒大海上威尼斯海景湾酒店
西藏国旅	西藏国际旅行社
西安夜宿华山二日纯玩游	西安华山跟团两日游
塞班岛自由行8天	塞班九日自由行
国色天香 成都	成都国色天乡
桔子精选成都环球中心酒店	成都桔子酒店精品
西域山水	西域山水酒店
成都棠湖中学实验学校	成都棠湖中学实验学校酒店
天柱县苏拉宾馆3	天柱苏拉宾馆
上海迪士尼门票 儿童	上海迪士尼门票老人票
珠海琴海童趣公寓	珠海琴海公寓
长龙航空行李额	金鹏航空行李额
中卫 星星故乡	中卫 星星的故乡
北京人大附中附近宾馆	北京大学医学部附近酒店
普陀山印象客栈	普陀山精品客栈
上海新虹桥国际医学中心	上海国际医学中心
秦皇岛鸽子窝附近民宿	秦皇岛北戴河鸽子窝附近民宿
北戴河爱尚家临海精品酒店	北戴河爱尚家酒店
阳溯画中游	阳朔画中游
芜湖方特三期	芜湖方特一期
莫干山温泉度假民宿	莫干山温泉别墅
黎川到南城	南城到黎川
塘子巷附近酒店	塘子巷站
浙江自驾三日游	浙江三天两晚自驾游
呼和浩特纯骑马	内蒙古学习骑马
兵马俑门票人工讲解	兵马俑人工讲解
上海迪士尼儿童票规定	上海迪士尼门票儿童
新疆旅游十日跟团游	新疆十日游
长沙芙蓉广场维也纳	长沙维也纳国际酒店芙蓉广场店
宁波东港波特曼大酒店	宁波波特曼酒店
杭州浙江警察学院	杭州浙江育英职业技术学院
蓬莱文成城	蓬莱文成
重庆成都5天4晚	重庆加成都5日自由行
Horbart tower	hobart tower
安顺黄果树风景名胜区	安顺黄果树风景名胜区-黄果树瀑布酒店
南京火车站到飞机场	五粮液机场到南京
厦门科技馆美食	厦门集美科技馆
Ai	aI
北戴河宠物酒店	秦皇岛北戴河可带宠物
西咸新区沣东新城	西咸新区沣西新城统一西路35号
东京到成都	成都到日本
铂尔登国际酒店	铂尔登酒店国际店
狼牙山索道	狼牙山景区索道门票
如家酒店上海打浦	上海如家酒店打浦桥
大连如家酒店三八广场店	大连如家酒店
武汉汉庭酒店洪	汉庭武汉洪山广场地铁站酒店
深圳宝安国际机场 锦江之心	深圳宝安机场锦江之星
扬州站	扬州东站附近酒店
青州酒店	青州站的酒店
新乡茉莉艺术酒店	新乡茉莉酒店
合肥一路同行淮河路步行街	合肥市一路同行酒店
洛杉矶酒店	美国洛杉矶酒店
跟团游西宁	西宁旅游
越南河内接机服务	越南河内接机
苏州创业园旁边酒店	苏州科技城酒店
厦门方特乐园	厦门方特水上乐园
青海大学附近酒店	青海师范大学新校区的酒店
大连香洲自助餐	自助餐大连
郑州逸泉国际酒店-会议厅	郑州逸泉国际酒店
临沂乐居精品酒店	临沂乐居精品
弥勒湖泉湾1号度假公寓	弥勒湖泉湾1号优家度假公寓
圆明园附近的酒店	圆明园附近酒店
孝南爱琴海	孝感爱琴海
东京京东大都会	大都会东京城饭店
京都园舞风馆	京都祗园舞风馆
千岛湖民宿酒店	千岛湖民宿
喆啡咸阳	喆啡酒店咸阳
三亚大东海附近景点	三亚景点 大东海旅游区
宜昌船柴	宜昌柴
庐山索道附近酒店	庐山南门
日本无线租	日本wifi随身
咸丰站	咸丰客运站
西岭雪山两大一小	西岭雪山山地
安吉晚餐	安吉下午茶
石家庄租车跑车	石家庄周边租车
泰安2日游	泰山二日游泰安出发
东莞周边自驾游	东莞自驾游
泛海钓鱼台早餐	泛海钓鱼台下午茶
泰安万达广场酒店	泰安万达广场
江汉区的酒店	江汉区
海南观音	海南南海观音
寓米公寓广州合生广场店	广州寓米公寓
滑石寨	滑石寨门票
三亚海棠湾喜来登御海棠	三亚海棠湾喜来登酒店套餐
桂林 度假	桂林旅游度假村
渠县賨人谷景区	渠县賨人谷景区门票
三亚七日游	三亚七日游纯玩
重庆沙坪坝三峡广场附近的酒店	重庆沙坪坝三峡广场酒店
成都东站住宿	成都东站
日本经典拼团一日游	日本经典一日
延安一日游黄帝陵	延安 一 日 游 黄帝 陵
亚朵s长沙	亚朵长沙
西双版纳万达乐园自助	西双版纳万达自助餐
济南到苏州的飞机	济南到苏州飞机
南京飞长滩岛自由行	长滩岛自由行南京
菲律宾长滩汉娜	菲律宾 长滩 汉娜
集安太极湾	集安太极湾山庄
上海到九华山跟团游	九华山二日游上海出发
太原出发山西五日游	山西5日游太原出发
神农架林区木鱼镇	神农架 林区 木鱼 镇
山东度假	山东省内旅游度假村
稻城亚丁8天	稻城亚丁旅游8天
安徽九华山跟团上海出发	安徽九华山跟团游
飞鲸卡	飞鲸
长葛到武汉	武汉到长葛
千那酒店	千那
贵州的火车票。	贵州火车票
迪斯尼香港儿童票	香港迪士尼儿童餐券
深圳皇牌国际酒店	深圳酒店国际
保山腾冲世纪金源大饭店酒店	腾冲世纪金源大饭店
福州一日游妈祖	一日福州
北京歌华开元大酒店附近酒店	北京歌华开元大酒店B座
2018旅游景区联票	旅游联票2018
马鞍山温泉度假	马鞍山温泉酒店
武汉城市便捷软件园酒店	武汉职业技术学院城市便捷
悦达商务酒店	悦达
南宁的酒店中山路	南宁中山路美食街附近酒店
肇兴酒店	肇兴
邛崃天台山露营	天台山邛崃
天伦wangchao	天伦王朝
海口疯狂水上世界	海口狂野水上世界
丽江自由行4天3晚	丽江四天三晚自由行
长兴水口乡	长兴水口
IU酒店·兰州高铁西站店	兰州iu酒店
达州主题酒店	达州情趣酒店
郴州五一电竞酒店	郴州电竞
千岛湖门票团体	团购千岛湖门票
广州上下九步行街美食特色	广州北京路步行街附近美食馆
澳大利亚流量包中国电信	澳大利亚中国电信流量包
上海 烧烤	上海野外烧烤
大慈寺门票	大慈寺一日
梅沙湾沙滩	梅沙湾沙滩公园
海口海大南门酒店	海口海大北门附近酒店
茅台到兴义	茅台飞兴义
苏州室内水世界	苏州乐园水上世界
淀山湖附近酒店	淀山湖附近的酒店
青海儿童旅游小团	青海儿童旅游
熬江镇酒店	江镇酒店
迪拜地接	迪拜地接地陪
沐野农庄	小镇沐野
小径湾一见钟情	华润小径湾一见钟情
南疆3天	南疆3日游
舟山好吃的	舟山吃
武汉悦兮半岛	武汉洪湖悦兮半岛酒店
鑫茂花园酒店深圳北站店	深圳鑫茂花园酒店
义乌诚信一区	义乌国际商贸城四区
美豪酒店 莘庄	美豪酒店莘庄
本溪隆兴酒店	本溪隆兴
无人机租借	出租无人机
上海迪士尼维也纳国际酒店	上海迪士尼维也纳酒店
柬埔寨西哈努克港	柬埔寨西哈努克港船票
涵田半岛度假酒店	涵田半岛酒店
武汉华美达广场酒店	武汉华美达光谷大酒店
水肺潜水考证	潜水考证
三亚湾红树林度假世界（棕榈王国酒店）	三亚湾红树林度假世界 
深圳到河北	河北到深圳
马仁奇峰芜湖市民票	芜湖马仁奇峰双人票
北京西站北广场酒店	北京西站北广场附近
尚幕	尚幕酒店
南阳龙湾温泉门前	南阳龙湾温泉
武陟 酒店	武陟县
老寨第一	第一寨
跟团3日游成都	成都游跟团三日
开封天鹅恋情侣主题酒店（原星辰恋情侣主题酒店）	天鹅恋情侣主题酒店开封
三亚的当地玩乐三亚景点	三亚的门票套票
威海7天	威海七天酒店
东莞古镇	东莞古村落
少林寺一日游自驾游	少林寺一日
半岭温泉酒店	半岭温泉门票
扬州1日游	扬州一日游跟团
哈尔雪谷客栈	哈尔滨雪谷客栈
太平山顶缆车和杜莎夫人蜡像馆	太平山缆车杜莎夫人蜡像馆
大地京闽	大地京闽酒店
宜昌芒果mini酒店	宜昌芒果MINI酒店
成都大熊猫繁育基地门票学生票	成都大熊猫繁育研究基地门票
京阪银座格兰德酒店	日本银座格兰德酒店
上海旗舰店	上海店
湖北省省博物馆	湖北省博物馆
如家快捷酒店杭州黄姑山路	杭州如家酒店延安路
山东省高级人民法院拍卖	山东高级人民法院
厦门旅游2日攻略	厦门2日游
g39	g35
丹麦乐高	丹麦乐高城
隆昌北站	隆昌站
哈利波特片场的门票伦敦	伦敦哈利波特片场门票
新疆乌鲁木齐市酒店希尔顿	希尔顿乌鲁木齐
呼和浩特东到呼和浩特	乌兰浩特到呼和浩特
飞机电子行程单	飞机行程单
林芝 拉萨 包车	拉萨林芝纯包车
新郑到海口机票	郑州到海口机票
红山国际大酒店	红山大酒店
万州青龙大瀑布	青龙大瀑布
monterey	Monterey
韶关经律论温泉小镇	广东韶关经律论国际温泉酒店
腾州酒店	滕州店
日本无线wife	日本无线wifi
龙门富力希尔顿	龙门富力希尔顿度假酒店
长沙南站休息室	长沙高铁站贵宾休息室
惠州城市职业学院东校区	惠州学院附近的酒店
江苏省宿迁市宿城区	宿迁市宿城区
平潭民宿	平潭岛名宿
重庆渝北区回兴街道宝桐路名宿	重庆师范大学大学城校区民宿
c长春影视城	长春影视城
武汉到安阳	安阳到武汉
金海湖游船票	金海湖门票
西安钟楼回民街附近的快捷酒店	西安钟楼附近连锁酒店
广州东站歌尔爵斯酒店	广州歌尔爵斯酒店
迟迟艺术酒店	迟迟艺术
贵阳市观山湖区长岭南路	贵阳市观山湖区观山西路
福建东山岛中驰山庄	东山岛中驰山庄
石家庄到四川	石家庄到成都
湖南郴州小东江民宿	郴州小东江景区里面民宿
长隆 白虎	长隆酒店白虎
珠海一日自驾游	珠海一日游纯玩自驾
郑州 汉庭	郑州的汉庭酒店
加州旅游	加州旅行
非洲动物大迁徙小团	非洲动物大迁徙
云南拼车自由行	云南 拼车
陕洲路	陕州路
宏村青梅学社	宏村青梅学社酒店
iccoa&	icoca
阳江四季洒店	阳江四季酒店
厦门黄厝海滩附近的酒店	厦门市黄厝海滩酒店
珠海 澳门 香港 厦门	香港珠海澳门
温州锐思特连锁酒店	锐思特酒店温州经济开发区店
海陵岛保利皇冠假日酒店奢华度假	阳江海陵岛保利皇冠假日酒店
办理港澳通行证	港澳通行证办理个人
花水湾王山别墅月麓湾二期	花水湾月麓湾王山别墅
昆明三天两晚	昆明三日游
三亚潜水ow特蒂斯	三亚亚特兰蒂斯潜水
海口机场免税	海口机场免税店
普吉岛机票自由行	普吉岛机票
西蒙人妖普吉岛包接送	普吉岛西蒙人妖接送
南通文峰宾馆	南通文峰饭店
鼓浪屿五大景点联票与船票	鼓浪屿五大景点联票
沈阳大东区	沈阳大东区东站街
璞隐酒	璞隐酒店
安徽黄山二日游跟团	安徽黄山两日游
长沙黄兴街	长沙黄兴步行街
六合霍山县漂流	霍山漂流
湛江霞山区美食	湛江 美食
成都麓山大道附近酒店	成都天府新区麓山大道
北京古北水镇御舍	北京古北水镇御舍套餐
溧阳1日游	溧阳一日
奔牛机场送机	奔牛机场
日本签证个人旅游广州国青	日本签证个人旅游广州
美国住北京领事馆燕莎	如家-北京燕莎使馆区美国使馆店
ow潜水菲律宾	菲律宾潜水证考证
泰国入境政策	泰国电子落地签
东莞麗枫	东莞 丽枫酒店
烟台维纳斯精选酒店	烟台维纳斯酒店
全南县的酒店	全南县
南昌滕王阁酒店	南昌滕王阁大酒店
贺兰县	贺兰县酒店
北京国家会计学院	北京物资学院酒店
海宁到长沙	长沙到海宁
蓬莱欧乐堡皇家骑士酒店自助餐	蓬莱欧乐堡骑士酒店
厦门飞台湾	厦门到台湾机票
成华希尔顿欢朋	成华希尔顿
泉州2日游	泉州周边游二日
盘谷花园	盘谷 花园
日本和服租凭	日本和服出租
海岛游装备	海岛旅游装备
欧洲旅行铁路火车票瑞士通票	欧洲旅游铁路火车票瑞士通票
西西的民宿	西西民宿
黄陵国家森林公园	黄陵国家森林公园的门票
南岳中心景区	南岳中心一日
西安铂菲朗致酒店	西安陕西铂菲朗致美酒店
十渡旅游	十渡一日游
瑞安中学	瑞安人民医院
电话上网卡	电话 上网 卡
鞍山公寓	鞍山日租公寓
松原的门票	松原当地玩乐
桂林市旅游攻略	桂林包车定制自由行
大唐芙蓉园门票与梦回大唐	西安门票 大唐芙蓉园门票+梦回大唐  大唐芙蓉园套票
广州天河希尔顿自助餐	广州希尔顿逸林酒店自助餐
平江路的家民宿	平江路 民宿
普吉岛旅拍	旅拍普吉岛
江西南昌汉汤温泉	南昌汉汤
三元酒店	三元
蓟县旅游团	蓟县跟团
日照海洋美学管	日照海洋美学酒店
联盛·九江快乐城	九江联盛快乐城
吉林松花湖万科	吉林万科松花湖
阳光海陵岛闸波海边别墅	阳光海陵岛保利银滩
天津米立方附	米立方天津
云南昆明到山东青岛机票	昆明青岛往返机票
融安玻璃桥	融安景区
福州汤	福州温泉泡汤
榆林七天连锁酒店	榆林如家快捷酒店
西安大雁塔讲解	西安古城墙讲解
青岛冰雪世界	青岛冰雪乐园
上海海洋水族馆门票当及	海洋水族馆门票上海
去哈萨克斯坦买随身wifi	哈萨克斯坦随身wifi
西安高新区亚朵酒店	西安行政中心高铁站亚朵酒店
知春东里15号如家	知春东里15号
广州至邵东	广州南到邵东
宜尚昆明	昆明宜尚
佛山美的鹭湖岭南花园酒店	佛山美的鹭湖岭南花园精品酒店
福州自由潜	福州自由潜2星
江门游乐场	江门游乐
汕头站酒店	汕头火车站及周边酒店
杭州博地中心丽筠酒店	杭州博地丽筠酒店
祥鹏航空延误险	航空延误险
徐州玩乐	徐州旅游区
周口东站附近的酒店	周口东站附近
新加坡亚洲文明博物馆	新加坡国家博物馆
沈阳双飞	沈阳 双飞
北京东隅酒店预定	北京东隅
泉城欧乐堡梦幻世界一日游	欧乐堡游梦幻世界
泸沽湖2天	泸沽湖2日自由行
杭州滨江区江南大道	杭州市滨江区东信大道
朴居酒店公寓	朴居公寓
张家界禾田居度假村	张家界禾田居度假酒店
仙本那 游玩	仙本那游
厦门 老人游	厦门老人
曼谷簽證	曼谷 签证
西安云朵	西安南门云朵酒店
太原二日游	山西二日游太原出发
深圳龙华地铁站附近酒店	深圳龙华地铁站
张掖丹霞地貌一日游	张掖七彩丹霞 一日游
千岛湖 家庭房	千岛湖家庭房
长沙钟点房	长沙钟点房五一广场
申根 旅游保险	申根签证保险
厦门鼓浪屿五大景点	厦门鼓浪屿景区
镇雄县的酒店	镇雄县酒店
桔子上海虹桥国展中心徐泾酒店	上海虹桥火车站桔子酒店
琼海万泉河休闲漂流	海南琼海万泉河漂流
阳江敏捷黄金海岸之星	阳江敏捷黄金海岸海之
锦江之星沧州开发区店	锦江之星沧州开发区酒店
蜈支洲岛一价全含	蜈支洲岛一价
腾州东	滕州东
安庆步行街	安庆人民路步行街酒店
九龙快捷酒店沙井店	深圳九龙快捷酒店
蒙特雷斯酒店乐山长青路店	蒙特雷斯酒店乐山大佛
新加坡滨海湾公园门票	新加坡滨海湾公园
南澳岛青奥湾	南澳岛青奥湾附近酒店
万信r酒店苏州	苏州万信r酒店
东京包车拍	东京包车
芭提雅步行jie	芭提雅步行街
稻城亚丁旅游色达拼车	稻城亚丁拼车自由行
良渚遗址公园一日游	良渚古城一日游
汉庭大连中山广场地铁站酒店	大连汉庭
普吉岛一普吉  蛋岛	普吉蛋岛
湘潭名宿	湘潭的民宿
送机福州	福州接机
枸杞岛附近的酒店等候	枸杞岛酒店
俄罗斯跟团游纯玩	俄罗斯旅游
洛阳市第九中学	洛阳市第一高级中学
深圳西冲1号沙滩民宿	深圳西冲民宿独栋
月亮湾跟团	月亮湾2日游
柳州跟团	柳州跟团游
江苏大学附近的酒店	江苏大学酒店
大理的圣托里尼	圣托里尼大理
光岳楼	光岳楼门票
深圳坪山到广州南站	深圳北站到广州南站
怀柔滑雪	北京怀柔滑雪
若尔盖跟团	若尔盖旅游
吉县虎口瀑布	山西吉县
赤峰2日游	赤峰两日游
鼓浪屿索道	鼓浪屿景点联票
长乔极地海洋公园的门票	长乔极地海洋公园门票
天津市和平区血液病医院	肿瘤医院天津
深圳出发跟团跟团游杭州	江浙沪游深圳出发
流量包 新加坡	新加坡上网卡
光敏公寓精品酒店	精品公寓酒店
武汉艺术馆	武汉湖北省美术馆
西双版纳出发跟团游	跟团游西双版纳
石家庄市第二十三中学	石家庄市第三十八中学
马来西亚 多次	马来西亚多次签证
西湖	西湖景区
肇庆七星岩风景区	肇庆七星岩
青神到成都东	青神到成都
沧州电影票	沧州电影
万州到武昌	万州到武汉
昆明市区如家酒店	昆明如家酒店
华硕	华硕酒店
轰趴聚会	聚会 轰趴
浙江省内海滩游	浙江海滩
杭州当地玩乐千岛湖	千岛湖的当地玩乐
桂林中心广场民宿	桂林市区酒店民宿
杭州自由行攻略	杭州游玩攻略
广东清远第一峰温泉酒店	清远第一峰温泉酒店
蓟州西井峪	蓟州西井峪优选民宿
斯里兰卡 wifi	斯里兰卡wifi
三亚 摄影	三亚个人写真拍照
中山三乡温泉别墅五房	中山三乡温泉别墅
成都老君山	老君山 成都
杭州的酒店希尔顿	杭州希尔顿逸林酒店
尚客优酒店泰州迎春路店	泰州 尚客优
郑州银基冰雪酒店酒店	郑州银基冰雪酒店
迪庆独克宗古城	迪庆藏族自治州独克宗古城
珠海横琴海洋王国	珠海横琴海洋
天津出海天	天津出海
连江平流尾地质公园	连江平流尾
石嘴山的当地玩乐	石嘴山周边游
云涛温泉花园	云涛森林温泉酒店
西双版纳万达皇冠假日自助餐	西双版纳万达皇冠假日 下午茶
广州崴格诗	广州 崴 格 诗
碧桂园润杨温泉酒店	惠州碧桂园润杨溪谷温泉酒店
深圳铂瑞斯行政公寓	铂瑞斯行政公寓(深圳福田会展中心店)
广州南酒店	广州南站酒店
凯宾连锁酒店成都香槟	成都凯宾连锁酒店
花筑奢陵水	花筑 陵水
大峡谷直升机	大峡谷直升飞机
搜国际酒店首尔明洞	首尔明洞洛伊斯酒店
三亚旅行摄影	三亚旅游跟拍
优选商务宾馆	优选宾馆
巧克力电竞主题酒店	巧克力电竞主题
护照翻译	签证翻译
puedro	pedro
江门古兜门票	江门古兜温泉门票
南京锦江之星酒店卡子门	锦江之星酒店 南京新街口店
曼谷夜场一日游	曼谷一日
海悦天地	海悦天地酒店
圣脱里尼	圣托里尼
西藏旅游深圳出发	西藏深圳出发
长沙一号公馆	长沙五一广场酒店一号公馆
浦江游船票	浦江游船船票
河源福和高级中学酒店	河源技师学院
天沭温泉	天温泉
上网卡全球	全球上网电话卡
南京建邺万达酒店	南京建邺区万达广场酒店
峨眉市酒店	峨眉的酒店
水云居	水云 居
白云洞景区	白云洞风景区
帝凯酒店	帝凯
普陀山名宿普济寺附近 家庭房	普陀山民宿普济寺
庐阳高级中学	庐阳高级中学附近的酒店
海外旅游保险马来西亚	旅游保险马来西亚
去常德	常德游
成都 西岭雪山	西岭雪山
合阳酒店	合阳北站
汉庭沈阳沈北大学城酒店	汉庭沈阳沈北大学城店
济南尚泉历舍酒店	济南尚泉历舍泉
厦门曾厝安民宿有阳台	厦门曾厝安民宿民宿
地窝堡国际机场	地窝堡机场酒店
日本团队签证	日本旅游团队签证
哈尔滨冰雪大世界夜场票	哈尔滨冰雪大世界晚上票
惠州万科双月湾西班	双月湾惠州万科
广州诺盟酒店公寓淘金地铁站	诺盟国际公寓广州淘金地铁站
飞猪双十一津贴	双十一津贴
自驾游赣州当地玩乐	赣州当地玩乐
汉庭长沙火车站地铁站酒店	汉庭长沙
手机卡德国	德国4g上网手机电话卡
湛江遂溪县的酒店	湛江遂溪酒店
香格里拉梅里雪山二日游	香格里拉梅里雪山两日游
杭州船游西湖	杭州西湖船
延吉长白山宾馆	延吉长白松宾馆
北京四日带双飞	北京四日双飞
宜必思尚品西安钟楼骡马市酒店	宜必思酒店西安钟楼店
宜昌湖北三峡技师学院酒店	宜昌湖北三峡职业技术学院酒店
沙巴红树林萤火虫半日游莹河红树林	沙巴红树林萤火虫半日游
迪斯尼年票	迪斯尼年卡
关门山国家森林公园本溪	本溪关门山
琶洲主题公寓	琶洲公寓
新加坡短信卡	新加坡新电信电话卡
营口鲅鱼圈兴辰休闲	营口鲅鱼圈兴辰
君兰丽江国际大酒店	君澜丽江国际大酒店
菲利宾薄荷岛	菲律宾薄荷
东升快捷酒店	东升商务宾馆
爱迪逊酒店	艾迪逊酒店
西北环线胡杨林	西北胡杨林
珠海的沙滩	珠海海滩
赛班岛酒店	塞班岛自由行亲子
青澳香湖湾海景公寓	南澳香湖湾海景公寓
昆明仟婵酒店	昆明呈贡仟婵酒店
佛山I主题公寓	佛山主题公寓
赤峰尚客优	赤峰尚客优酒店
舟山庙子湖酒店	舟山庙子湖岛酒店
阳江市海陵岛民宿	阳江海陵岛闸坡民宿
林丰温泉度假酒店	林丰温泉酒店
昆明观景望月酒店	昆明梦景望月精品酒店
蓟州宾馆	蓟州火车站
张家界国十里画廊	十里画廊张家界
哈尔滨中央大街希尔顿欢朋	哈尔滨希尔顿
香格里拉哈爬雪山	香格里拉哈巴雪山
大理喜洲古镇严家大院门票	大理喜洲杨家大院门票
北京黄寺大街酒店	北京黄寺大街
成都西南儿童医院附近宾馆	成都市四川省妇幼保健院酒店
青田千峡湖门票	青田 千峡湖
萍乡青年旅社	萍乡青年旅舍
贵阳会展中心亚朵酒店	贵阳北站亚朵酒店
宁夏理工学院	宁夏职业技术学院
大理古镇名宿	大理名宿
周边游南京	南京周边一日游
佛山旅行团	佛山旅游团
澳门Q立方王国	澳門Q立方
焦作云台山门票住宿	焦作云台山风景名胜区
西安软件园	西安中兴产业园
瑞安到淮南	瑞安到淮安
成都乐山大佛峨眉一日游	成都峨眉山乐山大佛一日游
自驾达古冰川	自驾游达古冰川
上海乐高探索中心长风	上海长风海洋世界和乐高
糖丸重慶	糖丸 重庆
福州永泰云顶2	福州永泰云顶
象山檀头山岛风景区酒店	宁波市象山县石浦镇檀头山岛
西双版纳花间堂	西双版纳花间堂酒店
三明大田茶天下度假区	三明大田茶天下
尚课优	尚课优连锁酒店
阳江海陵岛敏捷黄金海岸木	阳江海陵岛敏捷黄金海岸优扬
广州大学城体育中心	广州大学城附近酒店
贵州民族大学老校区	贵州大学北校区
广州市海珠区新港东路附近酒店	广州市海珠区新港东路
热门推荐惠州南昆山养生谷别墅	惠州南昆山养生谷别墅
长沙民宿 	长沙的民宿
驻马店市实验中学	驻马店市第四中学
安吉云中溪汤泉度假酒店	安吉雲中溪·汤泉度假酒店
霞浦县三沙镇	霞浦三沙镇
翠华山滑雪场	翠华山滑雪场一日游
满舍	满舍酒店
襄阳麗枫酒店	襄阳麗枫
南京至郑州	郑州到南京
云和长汀沙滩民宿	云和长汀沙滩
福州中庚聚龙	福州首开中庚聚龙精选酒店
河南经贸学院	河南经贸职业学院
开元芳草青青房车营地·海宁盐官店	开元芳草青房车营地海宁盐官店
恩施机场附近酒店	恩施许家坪机场附近的酒店
昆明南站接送	昆明 机场大巴
攀枝花市实验学校	攀枝花市凤凰小学校
野生动物园 海南	海南热带动植物园
悦尚宾馆南京解放路	南京悦尚酒店解放路店
街子古镇附近酒店	街子古镇酒店
张家界富兰特和酒店	张家界富蓝特和酒店
成都到亚丁包车	成都到稻城亚丁包车
曼谷杜莎	杜莎夫人曼谷
宁悦	宁悦酒店
厦门三个厦大人·HiAir民宿	厦门三个厦大人民宿hiair
青海 东台	青海旅游 东台
金华唯爱主题酒店	金华主题酒店
闻喜晋水湾	闻喜晋水湾水上乐园附近的酒店
皇城相府晋城	皇城 相府 晋城
大大小小梦想	梦想小
林芝旅游纯玩四天	林芝四天游
青年旅社长沙	长沙国际青年旅舍
濮阳蓝宝石温泉	濮阳蓝宝石温泉度假酒店
兰州市兰州中川国际机场-T2航站楼酒店	北方国际机场一兰州机场兰州
重庆IU	重庆解放碑iu
温泉酒店私人温泉	温泉 
上海迪士尼乐园双人成人3	上海迪士尼乐园双人票
富驿时尚酒店中关村	富驿时尚酒店北京
跟团国内游三亚	三亚跟团游纯玩
芭提雅一日游真理水上	芭提雅水上一日
北京十渎	北京十渡
香港迪士尼 双人套餐	迪士尼套餐香港
合肥大东门附近的酒店	合肥大东门地铁附近的酒店
人大附近酒店	人大西门
澳门自助餐 	澳門酒店自助餐
安徽查济古镇	安徽查济
兰州文化宫附近的酒店	兰州市东方红广场附近的酒店
桃花沟风景区	桃花沟门票
安吉-龙王山漂流附近的酒店	浙江安吉龙王山漂流附近酒店
法国电话卡长期	法国电话卡4g
奥纳瑞铂酒店	奥纳瑞铂
郑州锦衣城海洋馆	郑州锦艺城海洋馆
海洋 暹罗	暹罗海底世界门票
自由潜苏州	苏州自由潜
过云山居 苏州	过云山居苏州店
韩国。跟团	韩国团
衡阳旅游	衡阳跟团游
维也纳3好酒店（北京石景山万达西古城地铁站店）	维也纳3好酒店北京石景山
苏州园林酒店	苏州园林住宿
上海中心126层	上海中心126
大理海洋公园	大理海洋馆
五年多次 日本	日本五年签证
沈阳市第一二六中学	沈阳市第二十二中学
拖挂式房车	拖挂房车
武汉海昌极地海洋公园双人	武汉海昌极地海洋世界门票
三天二晚	三日两晚
啊啦的海水上乐园	阿拉的海水上乐园
蓬莱到聊城	烟台到聊城
怀化市维也纳酒店	维也纳国际酒店怀化
东莞-澳门	澳门东莞
义乌中心医院	义乌市中心医院
重庆天豪宾馆红旗河沟店	重庆天豪酒店
无锡江南大学附近	无锡市江南大学酒店
厦门南洋学院	厦门华夏学院
半自由行广州	广州半自由行
福建霞浦大金沙滩	福建霞浦大金沙滩民宿
杭州一日游亲子	杭州周边游一日杭亲子游
巫山酒店	巫山住宿
苏州市华谊兄弟	华谊兄弟影城苏州
滁州会峰路宾馆	滁州附近宾馆
美居酒店 兰州	美居酒店兰州
汕头南澳岛包车游	汕头南澳岛二日包车游
武汉大花岭地铁站e口酒店	武汉大花岭酒店
版纳万达水上乐园	版纳万达水乐园
心语花婉精品客栈	心语花苑精品客栈
万福西路	万福西路54号
香港海洋公园门票含餐	香港海洋公园门票含餐券
江湾景区门票	江湾门票
丽水三日游	丽水3日游
重慶住宿	重庆住宿洪崖洞
新西兰机酒自由行	新西兰自由行
武夷山跟拍	武夷山拍照
桂林阳朔古镇	桂林 阳朔 古镇
清远有哪些旅游景点	清远旅游景区
桂林4天3晚	桂林4天3晚当地团
石家庄如家中山东路北国商城店	如家石家庄中山东路北国商城店
龙门石窟 	龙门石窟团票
天美乐时尚旅馆	天美乐快捷酒店
土耳其移动无线	移动wifi土耳其
天津出发北京	天津到北京旅游团
临安卢荻温泉	临安芦荻温泉
丹嫩市场	丹嫩沙
恭王府攻略	恭王府一日
大连民宿海景别墅	大连民宿别墅
桔子酒店南京夫子庙	桔子南京新街口
天朗壹水湾度假酒店	天朗壹水湾
武汉海昌极地海洋公园大门票	武汉海昌极地海洋世界预约
定西市安定区公园路中学	定西市第一中学
泰国燕窝餐	泰国燕窝
迪士尼月卡	迪士尼门票季卡
dangdituan	当地团
潍坊市	潍坊市高新区
冰岛 包车	冰岛拼车
橄榄树主题酒店	橄榄树酒店
广州轻轨	广州城轨
武汉傅家坡客运站车票	武汉傅家坡客运站
西安丈八路立交附近酒店	西安雅居酒店丈八路店
佛山高明美的鹭湖探索王国套票	佛山高明美的鹭湖水上乐园门票
丽凯酒店	丽凯
徐州温德姆酒店	徐州温德姆
陕西师范大学长安校区	陕西科技大学西安校区附近酒店
新郑机场贵宾休息室	新郑机场休息室
房车长沙	长沙 房车
南昌县贝斯酒店	南昌贝斯酒店瑶湖
御汤山别墅	温泉别墅汤山
哈尔滨民宿短租房	哈尔滨中央大街民宿公寓
奎尔公园门票	奎尔公园
南昌火车站酒店七天优品	七天酒店南昌火车站广场店
池州到郑州	郑州到池州
曼谷去清迈拼车	曼谷包车去清迈
漂流邢台	邢台峡谷漂流
贺州上郡soho酒店	贺州上郡SOHO酒店
国内驾照换香港驾照	办理香港驾照
喜来登西双版纳	西双版纳喜来登酒店套餐
肇庆七星岩竹筏	肇庆七星岩游船
连云港观海度假酒店	连云港海景酒店
上海复旦大学附属儿科医院民宿	上海市第六人民医院附近民宿
东京迪士尼门票纸质	东京迪士尼门票
玉龙雪山进山证	玉龙雪山进山
深圳到上海	深圳至上海
西安跟团游4天3晚	西安旅游四天三晚纯玩跟团
开封河南大学酒店	开封河南大学金明校区附近酒店
成都自驾青海湖	成都到青海湖自驾游
两日游 上海周边	上海周边二日游
G56	g54
珠海大马戏	珠海马戏
巴厘岛出海	巴厘岛出海二日
三亚180度无敌海景房	三亚 180 度 无敌 海景 房
揭东区第一中学	揭阳揭东区第二中学酒店
千岛湖摩托艇	千岛湖 皮划艇
赣州黄金机场附近的酒店	赣州机场
杭州西湖附近名宿三人间	杭州西湖可住四人的酒店民宿
奥林匹克塔门票	奥林匹克塔
呆呆岛一日游	呆呆岛 一日游
柏维酒店	柏维连锁酒店
北海道公交卡	北海道kitaca
荆门艾美	荆门艾美城市酒店
l签直飞香港送关 海口	海口l签香港送关
佛山的如家酒店	佛山如家商旅酒店
杭州元旦跨年	元旦杭州
如家琵琶会展中心	如家会展中心
亲子周边	周边亲子
宿适轻奢酒店 打	宿适轻奢酒店
莲花客运站	莲花轻轨站
深圳较场尾海滩民宿	深圳较场尾宿恋海景民宿
钟山风景区门票套票	钟山风景名胜区大门票
香格里拉大酒店旗舰	香格里拉大酒店
锦江之星嘉兴	嘉兴锦江之星酒店
万达 电影票	万达电影乐园
车陂地铁站酒店	车陂南地铁站
澳门高铁	澳门车票
五江温泉	五江温泉度假酒店
三亚海月佳轩	三亚佳轩
北京汉庭优佳	汉庭北京
桂林本地跟团2日游	桂林两日游纯玩
春熙路亚朵	春熙路亚朵轻居
珠海到深圳包车	深圳珠海包车
阆中阆情主题酒店	阆中主题酒店
长岛说时依旧民宿	长岛说时依旧
娃娃体验馆	娃娃体验
广元火车站附近酒店	广元火车站附近旅店
大阪湾大厦酒店	大阪大厦酒店
西安城墙讲解	西安城墙一日游
杭州华住会酒店	杭州华住旗下酒店
洛杉矶好莱坞环球影城亲子票	洛杉矶好莱坞环球影城门票
漫珠沙华	曼珠沙华
观澜水上田园	观澜山水田园水上乐园
哈尔滨到日本机票	东京到哈尔滨的机票
阜宁天鹅湖大酒店	阜宁天鹅湖酒店
深圳国际会展中心商圈附近的酒店	深圳酒店会展中心
三亚 热带雨林	三亚热带雨林
宜昌均瑶广场附近酒店	宜昌市一中新校区
三亚天域4天3晚	三亚天域度假酒店4天3晚
三亚半自由	半自由行三亚
云南租车敞篷	云南租车自驾
福田区酒店	福田区
舟山朱家尖东沙民宿	舟山朱家尖南沙民宿
广州天河客运站附近酒店	广州天河客运站酒店
大理海湾国际大酒店	海湾国际大酒店大理
慕田峪长城一起游	慕田峪长城
宿迁到苏州	苏州到宿迁
之茂酒店西安	之茂酒店（西安钟鼓楼回民街洒金桥地铁站店）
全季酒店深圳南山区	全季深圳北站酒店
天门山玻璃桥	天门 山 玻璃 桥
从喀纳斯骑马去禾木	怎么从喀纳斯去禾木
东莞东至广州	东莞广州东
丽江官方酒店花园别墅	丽江整套别墅
西安的民俗	西安民俗住宿
菏泽二中	菏泽一中南京路校区
成都地铁3号线	成都地铁2号线
黄山风景区门票景交车	黄山风景区新国线车票
普吉东方水疗	泰国按摩东方
梅林酒店	梅林
漳浦酒店	漳州漳浦酒店
北京酒店泳池	北京泳池酒店
香港杜莎夫人蜡像管门票	买即发香港杜莎夫人蜡像馆太平山顶杜莎夫人蜡像馆门票香港蜡像馆
西安酒店景点	西安 酒店 景点
珠峰大本营羊湖三日游	珠峰大本营羊湖3天2晚
南昌万达主题游乐园	南昌万达主题乐园
郑州火车站地区附近民宿	郑州火车站地区酒店
西双版纳跟团游	西双版纳跟团
赫章到贵阳	贵阳到赫章
汶川到九寨沟	成都出发九寨沟汶川
普瑞斯s酒店	普瑞斯s
找代驾	长途代驾
西班牙跳伞啊	西班牙跳伞
汕头到武昌	武昌至汕头
威海美尓雅	威海美尔雅
宁波象山海边民宿别墅	宁波象山海边民宿无敌海景
王家大院拼车	王家大院包车
大阪环球影城 大门票	大阪环球影城的门票
惠州龙门南昆山大观园别墅	惠州龙门南昆山大观园度假区
格林精选	格林
西安北大街交大附属二院宾馆	西安交大附近宾馆
上海回广州	广州上海
平潭 出海	平潭岛出海
丽江古城到香格里拉	丽江到香格里拉车票
马六甲的酒店	马六甲酒店公寓
兰州大学附近民宿	兰州大学民宿
适合老年人的九寨沟游	九寨沟老年团
南亚酒店	南亚 酒店
佛山的门票	佛山旅游景点
厦门一中初中部	厦门五缘第二实验学校中学部
如家雅宝路	如家 雅宝路
西单附近酒店	西单/金融街附近的酒店
租租车 土耳其	土耳其租车
长沙AI兮·江景民宿	长沙的民宿江景
杭州南方路岚水国际青年旅舍	杭州岚水国际青年旅舍
珠海情侣路海滨浴场酒店	珠海情侣路附近的酒店
上海师范大学徐汇	上海华东理工大学徐汇校区
苏州格雷斯	格雷斯苏州
福建工业学校酒店	福建理工学校
三天游北京	北京三日纯玩团
常州工学院继续教育学院	常州技师学院
全季合肥长江东路酒店	全季合肥淮河路步行街酒店
昆明南到长沙	长沙到昆明
大连发现王国度假酒店电话	大连发现王国度假酒店酒店
广东景点	广东一日
上海苏州的酒店万豪	苏州太湖万豪酒店
山西太原平遥古镇	太原平遥古城
顺风车中山	中山一日游包车
港口	港口客运站
吉林长春科技学院	长春吉林工程技术师范学院
	广州市从化温泉明月度假别墅
喜客精品酒店	喜客精品
墨隐	隐墨
武汉到海南飞机票	武汉到海南的机票
日本富士急行线	日本富士急行
广州到香港火车	广州到香港火车票
云上草原自由行	云上草原2日
黄山一水山庄酒店	黄山一水山庄
公主号 美国	美国公主邮轮
香港迪斯尼乐园年卡	香港迪士尼乐园车票
泰顺度假	泰顺温泉度假村酒店
红池坝风景区	红池坝门票
青岛市城阳区职业教育中心学校	青岛市城阳区实验中学
杭州西湖酒店公寓	杭州西湖区酒店式公寓
蹈城亚丁	稻城亚丁
深圳福深达	深圳福
菲律宾电话卡郑州	菲律宾电话卡
萧山机场停车位	萧山机场停车
毕节云上草海酒店	毕节云上草海
桂林市区名宿	桂林市内民宿
红果气车站	红果汽车站
上海复旦大学附属眼耳鼻喉科医院酒店	上海复旦大学附属眼耳喉鼻医院
亚朵轻居 北京	北京建国门CBD亚朵轻居
科北京科技馆	北京科技馆
巫山旅游景点	巫山旅游
伊宁锦江之星大酒店	锦江之星(伊宁火车站店)
蒙自惠民小学	蒙自第二中学
芒康盐井	芒康盐井住宿
桂林高新万达广场	桂林万象城酒店
巴厘岛滑翔翼	巴厘岛滑翔
新西兰 克纳克城堡	新西兰城堡
深圳桂林阳朔自由行四天三晚双飞	桂林阳朔自由行四日深圳
白龙观	白龙 观
西安西北工业大学	西安西北工业大学友谊校区酒店
遂宁温泉	遂宁 温泉酒店
赣商	赣商酒店
烟台海景民宿	烟台民宿海边
澳門觀光塔	澳门 观光 塔
青航酒店	青航
襄阳市中医医院	襄阳市中心医院附近的酒店
安庆亚朵	安庆亚朵酒店
金华方岩景区	金华方岩
湖南6天5晚	湖南旅游6天5晚
厦门火车站包车	厦门火车站
安徽看日出	安徽 一日游
沙家浜冰雪节	沙家浜
墨尔本88层观光	墨尔本88层
三亚丽禾温德姆万丽	三亚丽禾温德姆
三亚跟团纯玩游5天4晚	三亚旅游5天4晚纯玩跟团
西安4天3晚 	西安4天
舟山海滩自由行	舟山自由行
喀纳斯 包车	喀纳斯包车游阿勒泰
西双版纳 曼听公园	西双版纳曼听公园
三亚亚龙湾酒店三人间	三亚三人间
陵水三角梅	陵水 三角梅
苏梅岛深潜一日游	苏梅岛深潜
朱家尖禅露度假村酒店	舟山市朱家尖禅露
顺德城轨站	顺德印象城
徂徕山滑雪场	 徂徕山滑雪场
福清市永鸿温泉	福清永鸿温泉度假酒店
桔子精品酒店太原	桔子酒店太原
新郑酒店	新郑的酒店
黄陂盛天农庄	黄陂胜天农庄
南京清沐精品酒店西善桥店	南京清沐东善桥
万宁浆板	万宁 浆板
福州罗源县罗源湾大酒店	罗源县罗源湾海洋世界酒店
富春开元方草地	富春开元芳草地
淝河	汊河
长沙雨花区民政职业技术学院	长沙电力职业技术学院
三亚亚龙湾3天2晚	三亚亚龙湾酒店三天两晚
金沙湾佳兆业万	佳兆业金沙湾
四川九寨沟广州出发	九寨沟广州出发
泰国机场行李托运	行李托运泰国
蓝溪国际大酒店	蓝溪国际酒店
周口文泰酒店	周口宏泰酒店
石家庄到三亚机票	石家庄到三亚的机票
成都宽窄巷子民宿4人	成都宽窄巷子民宿4
东阳全季	东阳全季酒店
亚布力滑雪度假区旗舰店	亚布力滑雪套餐
南京百家湖	南京百家湖酒店
粘花湾附近的酒店	拈花湾酒店
新会古兜温泉水世界	广东江门新会古兜温泉门票
广州花海街	广州花海
新加坡儿童交通卡	交通卡新加坡
银川游	银川跟团游
青岩古镇附近民宿	青岩古镇住宿
银川国贸新天地酒店	银川文化艺术博览中心
长滩岛一日游项目	长滩 岛 一 日 游 项目
云南大理洱海天空之境酒店	云南大理洱海天空之境
金华天逸精品酒店	金华天逸
香港航空公务舱	商务舱香港
漳州到诏安	福州到诏安
北京周边特色民宿温泉	北京温泉农家乐
雅安碧峰峡天桥酒店	雅安碧峰峡酒店
珠海金湾区酒店	珠海国际会展中心附近酒店
从长沙出发北京三天游	长沙三日
外伶仃岛一日游	外伶仃一日游
广州花园	广州花园酒店
成都西岭雪山别墅	成都西岭雪山温泉别墅酒店
保定大午温泉酒店	保定大午温泉假日酒店
湖州喜来登酒店自助餐	湖州喜来登大酒店自助餐
福州永泰温泉别墅	福州永泰温泉酒店
西安赛格国际购物中心附近民宿	西安北站附近酒店民宿
襄阳攻略	襄阳旅游攻略
长沙湖南生物机电职业技术学院东湖校区酒店	长沙湖南生物机电职业技术学院
厦门快捷酒店	厦门火车站附近
乌鲁木齐地窝堡机场酒店 	乌鲁木齐地窝堡机场酒店
杭州周家村	杭州 周家 村
青岛到蓬莱机场	烟台到青岛机场
日照的酒店如家	日照如家
广州+香港	香港直通车票
株洲方特欢	株洲方特乐园
天台县塔后民宿	天台县民宿
苏州园林附近的民宿	苏州园林名宿
杭州 雪	杭州雪
昆山汉庭火	昆山汉庭
首尔免税店	韩国免税店直邮
99优选上海人民广场酒店	99优选上海南站地铁站酒店
泰山门票红门	泰山一日红门
泰安7天酒店	泰安七天连锁酒店
明宇旗舰	明宇酒店旗舰店
航空小镇开元曼居	开元曼居航空小镇
普达措车票	普达措拼车
海南陵水清水湾阿罗哈	海南陵水清水湾阿罗哈酒店套餐
清远白天鹅温泉门票	清远白天鹅温泉
常州站布丁酒店	布丁酒店常州
重庆wuji	重庆wuji酒店
海洋馆门票	海洋馆
维也纳酒店 南京五塘广场店	维也纳国际酒店（南京南站南广场店）
短租房西安一个月	西安月租房
阳朔东舍精品酒店	桂林阳朔东舍精品酒店
上海迪士尼地接送	上海迪士尼接送
大理洱海边附近客栈	大理洱海海景客栈
榆林榆阳机场宾馆	榆林市榆林榆阳机场酒店
天津南到滨海	天津站到滨海
广州沙河服装批发城酒店	广州市广州沙河服装市场酒店
重庆大学城西街	重庆熙都酒店大学城熙街店
北京到揭阳	揭阳到北京
北京玉泉商业中心	玉泉商业中心
桔子酒店三元桥	桔子三元桥
mba	mba酒店
厦门旅行 云水谣 土楼二日	厦门云水谣土楼二日
阿尔山4日	阿尔山4日游
长兴南站	长兴高铁站
烟台蓝屿	烟台蓝屿酒店
三明第三中学附近的酒店	三明一中附近
河源龙川站酒店	河源市龙川火车站
宁波大学台州宾馆	宁波市庄市大道台州宾馆
湖北泡温泉	湖北温泉度假村
赣州南门口附近的酒店	赣州南门口酒店
山东跟团游五天四晚双飞暑假	山东5日游
大理乘闲	大理闲乘
常州 喜来登	常州富力喜来登
神州租车威海	威海租车自驾游
广州从化水上精品酒店	从化水上精品
普吉岛一日皮皮岛	普吉岛一日游皮皮岛深潜
赤峰万达嘉华	赤峰富力万达嘉华
济南市出租房	济南 市 出租 房
拍婚纱云南	云南旅拍婚纱摄影
羊城通犬夜叉	羊城通
萨利色尔卡滑雪	萨利色尔卡滑雪场
重庆西南医院体检中心附近酒店	重庆沙坪坝区西南医院附近酒店
郑州管城回族区	河南省郑州市管城回族区
南昌到铜仁	铜仁到南昌
西双版纳景洪泰森格大酒店	景洪泰森格大酒店
领好奕墅精品汽车酒店	领好·奕墅酒店
青岛如家栈桥	青岛的如家酒店
六安解放路第二小学	六安解放路小学
常州中华恐龙园景尚酒店	常州景尚恐龙园主题度假酒店
重庆联合国际大厦	重庆解放碑新华路联合国际大厦
宏村逸客	宏村逸客精品酒店
龙王潭生态旅游区	龙王潭
帝景度假啊	曼谷帝景度假村
陕州温泉	陕州区温泉酒店
镇远漂流门票	镇远漂流
珠海情侣路附近的酒店	珠海情侣南路酒店
荆门海港城酒店	荆门海港城
古北水镇长城门票	古北水镇 长城
瓦屋山国家深林公园	瓦屋山国家森林公园
尾单特价日本青岛	日本特价尾单
广州熊猫一天一晚	广州熊猫三日
哈尔滨波塞冬海洋王国鲨鱼酒店	哈尔滨波塞冬海洋王国鲨鱼
漫心 夏都小镇	漫心夏都小镇
天津市蓟县	天津市蓟县酒店
大理到丽江的汽车	丽江到大理汽车
榆林两日游	榆林当地二日游
上海外滩悦榕	上海外滩悦榕庄
上海维也纳浦东金桥店	上海金桥维也纳
西安一黄河壶口一日游	西安壶口一日
北京故宫长城	北京 故宫 长城
一日游香港长洲	香港一日
广州佳圆宾馆	广州佳圆
湖州水上	湖州水上乐园
内蒙古呼伦贝尔大草原跟团游	呼伦贝尔纯玩跟团游
太平山 套票	太平山蜡像馆门票
稻城亚丁毕棚沟	稻城亚丁二日游
清迈塔牌门	清迈塔佩门
真航空行李	航空行李
黄山奇石	黄山旅游奇石
太原慈善职业技术学校附	太原慈善职业技术学院
九寨沟二日游	九寨沟两日游
佛山顺德长鹿农庄门票	佛山顺德长鹿农庄酒店加门票
金华武义清水湾沁温泉凡尔赛宫	金华武义清水湾沁温泉门票
日本达摩卡	日本docomo卡
汉庭西安北大街十字酒店	汉庭酒店西安
榆林镇一日游	榆林一日
河源客天下温泉别墅	河源客天下度假别墅
江苏昆山度假村酒店	昆山度假村酒店
清远 包车	清远包车
昌江松之光酒店	昌江黎族自治县昌江松之光酒店
宁波广播电视大学	宁波大学东校区
上海民宿别墅	上海民宿带泳池
海洋公园 新加坡	新加坡海洋馆
苏州长圻码头	苏州东山长圻码头
99连锁旅馆北京昌平火车站	99旅馆连锁北京昌平火车北站西关路店
汉庭酒店兰州广电中心店	汉庭兰州广电中心酒店
赣州出发跟团游北京	赣州到北京旅行团
新加坡海洋公园	新加坡海底世界
咸宁的温泉酒店	咸宁 温泉
重庆nanshan	重庆南山
乐在民宿	乐在名宿
香港去澳门玩	澳门去香港
惠州双月湾 虹海湾二期	惠州双月湾虹海湾一期
钱江灯光秀	钱江夜游
浙江二日游纯玩	浙江省内二日游
上海宏轩涞坊连锁九亭酒店	上海宏轩酒店
泉州东南医院	泉州儿童医院站附近的酒店
保定 亚朵	保定亚朵
广州壹舍	壹舍 广州
株洲神农谷国家森林公园	株洲湖南神农谷
博越	博越精品
广州火炉山森林公园	广州火炉山森林公园门票
水屋	水上屋
一栈	一 栈
南京市栖霞山风景区附近的酒店	南京市栖霞山一日附近酒店
速8酒店洛阳	洛阳市速8酒店
哈尔滨市道外区	哈尔滨道外区
重庆一武隆	重庆市重庆武隆
潜水证考证ow	潜水 证 考证 ow
北戴河和坝上草原	北戴河坝上草原
历山舜王坪风景区	历山舜王坪
湖州太湖龙之梦酒店	湖州太湖龙之梦乐园酒店
曼哈顿珠海	曼哈顿 珠海
酒店早餐包月	早餐 包月
北京颐和园电子导览解说	北京颐和园电子讲解
郑州布丁精品时尚酒店	郑州布丁时尚酒店火车站店
天定山滑雪	天定山滑雪门票
烟台芝罘区滨海广场附近的酒店	烟台芝罘区环山路附近的酒店
丽江泸沽湖大落水村酒店	丽江泸沽湖大落水村民宿
长沙火车南站停车	长沙南站停车
北京旅游五星酒店	北京酒店旅游
特价往返机票桂林	含机票桂林
全季酒店武林门	全季武林门
绍兴兰亭安麓	绍兴兰亭安麓酒店酒店套餐
郑州皇冠	郑州皇冠酒店
涠洲岛上酒店270度	涠洲岛270度城堡酒店
杭州萧山国际机场大酒店	杭州萧山国际机场
如家商旅酒店上海外滩四川北路	如家精选-上海外滩四川北路地铁站店
全球通用充电转换器	全球 通用 充电 转换 器
江西南昌理工学院周边	江西南昌理工学院
上海市青浦区酒店	上海市青浦区
汕头到上海	上海到汕头
广州市南沙天后宫酒店	番禺南沙天后宫
三亚飞机场里面的酒店	三亚机场海边酒店
杭州馨乐庭	馨乐庭杭州
温州市区一日游	温州一日游景点
长兴太湖龙之梦	长兴太湖龙之梦钻石酒店
三亚3日游纯玩团	三亚三日游跟团游
苏州 温泉 情侣	苏州天颐温泉
佛山市容桂商圈酒店	佛山市容桂客运站酒店
君都枫叶酒店	君都枫叶
耒阳至长沙	长沙到耒阳
云海岸酒店	云海岸度假酒店
如家 五棵松	如家精选酒店北京五棵松
长沙天心区青雅丽发学校	长沙市天心区青雅丽发学校
clubmed官方 普吉岛	clubmed  普吉岛
格拉斯里新宿	格拉斯新宿
台湾流量卡中华电信	台湾电话卡中华电信
民宿 长沙	长沙名宿
长沙考试院	长沙民政职业技术学院
郑州市商业技师学院	郑州市技师学院
霍比特人村萤火虫	霍比特人村
秦皇岛天水跟团游	跟团游秦皇岛
城市便捷桂林阳朔十里画廊店	城市便捷桂林阳朔西街店
晋城美景之旅酒店国贸店	美景之旅晋城物贸广场
宜昌均瑶禧玥酒店背包客	宜昌均瑶禧玥酒店
武汉理工大学余家头校区民宿	武汉工程大学流芳校区民宿
杭州西湖和房汉庭	汉庭杭州西湖
重庆南温泉温泉	重庆南温泉南
神州租车南宁	南宁机场租车
长隆海洋王国马戏团	长隆海洋王国大马戏
信阳景点	信阳的门票
黃姚古鎮	黄姚古镇 
酒店太古里	太古里附近酒店
陕西旅游攻略	陕西攻略
如家商旅芙蓉	如家酒店芙蓉广场
广州市长隆家庭联票	广州长隆家庭门票
马尼拉一日	马尼拉跟团游
广西北海自一日游	广西北海一日
哈尔滨飞西双版纳	哈尔滨到西双版纳机栗
郑州蓝天时尚主题酒店	郑州蓝天商务酒店二七万达店
蓝湾绿城威斯汀	绿城蓝湾威斯汀酒店
杭州有带浴缸的酒店	杭州有浴缸的酒店
上海七天连锁	上海七天
湛江跟团	湛江三日游
迪士尼半日	迪士尼门票半日
重庆北站七天连锁酒店	重庆七天
济南希尔顿欢朋	济南希尔顿
西岭雪山两天一夜	西岭雪山两日游
德诚	德诚大酒店
成都去九寨沟包车	九寨沟包车到成都
杭州西湖汉庭	杭州汉庭西湖
游轮欧洲	欧洲邮轮
游艇 千岛湖	千岛湖 游艇
境外包车	海外包车
常州悠态 尊享酒店	常州悠态尊享
西安到延安壶口瀑布一日游	西安到壶口瀑布一日游
浏阳漂流一日游	浏阳凤凰峡漂流一日游
恩施最值得去的景点	恩施城区游
重庆渝中区酒店	重庆市渝中区酒店
南京年卡	南京旅游景点的年卡
石家庄尚如短租公寓	石家庄1＋1短租酒店式公寓
武当山修行	武当山修道
广州长隆动物	广州长隆野生动物世界
音乐名宿	音乐民宿
冈仁波及	冈仁波齐
北戴河御墅龙湾酒店式公寓	北戴河御墅龙湾酒店
汉庭南京软件大道地铁站酒店	汉庭南京南站软件大道酒店
南京南到绍兴	绍兴北到南京
九寨黄龙自由行	九寨黄龙纯玩团两日
上海上虹桥火车站	上海虹桥火车站接
密云一日游	北京密云一日游
贵阳南明区观水路附近的酒店	贵阳市南明区酒店
海港英迪格天津	海港英迪格
长沙到北京高铁票	长沙到北京高铁
惠州巽寮湾圆梦酒店位置	惠州巽寮湾圆梦酒店
东钱湖陶公岛	东钱湖陶公岛景区
通化市的酒店	通化市第一中学
新加坡雅诗阁酒店	新加坡雅诗阁
迪士尼夜场门票上海	上海迪士尼夜场
潜水证aid	paid潜水证
烟台的	烟台 
敦煌影视古城大门票	敦煌影视
怡莱酒店 横店梦幻谷精品店	怡莱横店影视城精品酒店
大鹏较场尾	大鹏 较 场 尾
彩虹旅舍香港	香港彩虹旅馆
香港境外流量包 	香港流量包
福州首开中庚聚龙	福州首开中庚聚龙精选酒店 
特价往返机票昆明	自由行机票往返昆明
广州增城香江健康山谷晨光	广州增城香江健康山谷
景德镇九集	景德镇九集小镇
青岛啤酒节时间	青岛啤酒节
嘉应学院医学院	嘉应学院
方糖酒店	方糖
广州南到富宁	富宁到广州南
千岛湖一日精品游杭州出发纯玩	千岛湖一日游当地参团
成都熊猫主题公寓式酒店	成都春熙路熊猫主题酒店
恒大酒店自助餐	恒大 自助
三亚机场接机至亚龙湾	接机服务三亚
临汾网虫公寓二部	临汾网虫公寓八部
宁波游乐园门票	宁波游乐园一日
澳门威尼斯贡多拉船游	澳门威尼斯贡多拉
郴州温泉门票	郴州 温泉
珠海医院	珠海市第五人民医院附近的酒店
成都嘉年ceo	成都嘉年ceo酒店
螺髻山九十九里温泉瀑布跟团	螺髻山九十九里温泉
厦门旅游记	厦门旅游游记
长隆帐篷	长隆 帐篷
租wifi美国	wifi租 美国
八方连锁酒店(河源高新区店)	八方连锁酒店河源
沈阳到杭州往返	沈阳到杭州自由行
宣恩伍家台乡村休闲度假区	宣恩伍家台
九华山民宿山上	九华山风景区民宿
万科滑雪	万科 滑雪
新疆乌鲁木齐租车	新疆 乌鲁木齐 租车
杭州东到苏州	苏州到杭州
长城 飞机	长城直升飞机
西安旅游3日游	西安3日游
重庆希岸酒店五里店	希岸酒店重庆
镰仓 一日游	镰仓一日游
清迈越野atv	清迈atv
老兵军旅客栈  大理	大理老兵客栈
重庆到天津的	重庆到天津
蜜月 海岛	暑假海岛游
如家上海徐家汇	如家精选酒店上海徐家汇店
兰溪香格里拉	兰溪香格里拉酒店
上海市徐汇区汾阳路	上海市徐汇区汾阳路83号
安吉中国大竹海	中国大竹海门票
广州江南西地铁站酒店	广州江南西酒店
罗源海洋馆门票	罗源海洋世界门票
凉山邛海宾馆	凉山邛海公园附近的酒店
汕头跟旅游团去厦门	汕头厦门旅游
福州福建农林大学	福州福建师范大学协和学院酒店
射阳县第三中学	射阳县酒店
澳门十六索菲亚	澳门十六浦索菲特大酒店
租私人飞机	租 私人 飞机
天津于家堡速8	速8酒店天津长江道店
宁夏小团	宁夏6日游
北京过圣诞	北京圣诞
成都出发西藏跟团游	西藏旅游成都出发
郑州市人民公园	郑州市文化路78号
丽江七星街住宿	丽江七星街
小小山峡	小小三峡
成都华阳地铁站酒店	成都华阳附近的酒店
海棠湾9号度假酒店套房	海棠湾9号度假酒店
爱丁堡国际酒店厦门	厦门市爱丁堡酒店
余杭西站	杭州余杭高铁站酒店
石家庄跟团	石家庄跟团游
成都到九襄	成都至九襄
青岛喜来登大酒店	喜来登酒店青岛
北京到承德火车票	北京至承德火车
日照海上	日照万平口海水浴场
富春江旅游攻略	富春江旅游
杭州西湖一日游导游	杭州西湖一日杭州
上海小龙虾	上海自助餐小龙虾
咸宁万豪温泉温泉谷公园道酒店	咸宁万豪温泉
九江庐山云里客栈	九江庐山山上住宿
延庆格林豪泰	延庆格林豪泰酒店
disney旅拍	迪斯尼拍照
杭州环北丝绸服装城	杭州市杭州环北丝绸服装城
庐山花缘谷	庐山花源谷
顺德长鹿农庄	顺德 长鹿 农庄
开封大学	开封大学北校区附近的酒店
芭堤雅四方水上市场 下午出发	芭堤雅四方水上市场
维也纳广州南高铁站店	维也纳广州南站
上海浦东机场核心区附近的酒店维也彻	维也纳酒店上海浦东机场店
安吉民宿温泉	安吉周府民宿
衡阳市公共资源交易中心	衡阳市教育考试院
巴中利达酒店	巴中市利达酒店
海口市万达广场(海口店)酒店	海口酒店 日月广场
三亚旅游景区	三亚好玩的景点
上海都市旅游卡	上海一卡通
东疆港酒店	东疆港附近的酒店
厦门中山路海景和颐酒店厦门时代雅居	厦门中山路海景和颐酒店
长城建国饭店	长城饭店
惠州双月湾酒店公寓	惠州双月湾万科二期酒店
三亚海洋馆自由潜	三亚 海洋馆 潜水
跟团济洲岛	济州岛跟团游
扬州出发越南	越南广州
隐然民宿	隐然精品民宿
重庆大学城嘛嘛公寓	重庆嘛嘛公寓
深圳南山区桃园地铁附近酒店	深圳市桃园站酒店
桑上海欢乐谷玛雅	上海欢乐谷玛雅
重庆 四人间	重庆人间
兵马俑华清池长恨歌半日游	兵马俑华清池长恨歌一日小团
福州 厦门	厦门福建
汉庭酒店合肥淮河路步行街店	汉庭合肥淮河路步行街酒店
亚庇岛麦哲伦	亚庇麦哲伦
中国天眼迎宾	天眼迎宾
太原出发山西全景游七日	山西全景游7日游
天津 地陪	天津地铁
如家-呼和浩特体育场地铁站店	呼和浩特如家精选酒店
9号宇宙科学探索馆	9号宇宙科技探索馆
上海名宿市中心	上海民宿市中心
上海维也纳酒店高速路	维也纳酒店上海路
梅州丰顺温泉酒店	梅州丰顺温泉别墅
武汉中南路酒店	武汉中南路地铁站附近酒店
马来西亚国家清真寺	马来西亚 国家 清真 寺
香港森铂尔曼酒店	香港铂尔曼酒店
杭州市杭州下沙高教园区酒店	杭州市下沙区电子科技大学酒店
甘南3	甘南6
杭州下城区西文街	杭州西文街附近酒店
iphone6p手机膜	iphone6s手机
华为充电器	华为手机充电器
莒南天马岛	山东临沂莒南天马岛门票+游船+登山 天马岛电子票 当天可定免预约
白玉兰酒店北京	北京白玉兰
四川国际旅行社	四川国际旅行
曼谷 野生	曼谷动物园
珠海必去景点	珠海旅游景点门票
德州到天津的火车票	天津到德州
天柱山桃源人家大酒店	天柱山附近的酒店
羊肉火锅	羊肉锅
广州长隆野生动物园	广州长隆野生动物园亲子
房车营地惠州	惠州房车酒店
广州花田小山居	广州 花田 小 山 居
鼓浪屿船票码头	鼓浪屿船票第一码头
杭州站接车	杭州接车
天门到重庆	张家界到重庆
广州增城二龙山花园门票	广州增城二龙山
青岛七天连锁酒店杭州路	七天连锁酒店青岛
雁荡温泉	雁荡山温泉
杭州西湖天地酒店	杭州西湖区的酒店
婚纱照旅拍毛里求斯	旅拍毛里求斯
国家间谍博物馆	国家博物馆
常德华天假日大酒店	常德华天大酒店
希岸酒店郑州高铁站店	郑州希岸酒店
安吉客运站附近的酒店	安吉市区酒店
诺盟锦源国际公寓	诺盟酒店公寓锦源
张家界景点门票	张家界景点
附近羊肉泡	西安旅游 化觉巷清真寺门票 西安清真寺门票 牛羊肉泡馍 品味茯茶
杭州柏悦酒店bar	杭州柏悦酒店
宝兴达瓦更扎大酒店	宝兴达瓦更扎印象酒店
厦门七天酒店悦华	厦门酒店七天
九江永修站酒店	九江永修县酒店
若尔盖草原三日游	若尔盖大草原3日
广州南到韶关的高铁	广州到韶关高铁
皮皮岛甲米	甲米pp
合肥到昆明	合肥至昆明
上海长清海洋馆	上海海洋水族馆
广东省温泉度假村	广东温泉度假酒店
上海至阜阳火车票	上海到阜阳火车票
川西旅游小团	川西旅游
亚特兰蒂水族馆	亚特兰斯蒂水族馆
北海市老街附近酒店	北海酒店老街
湖州 度假村	湖州度假酒店
郑州市郑州银基冰雪酒店	郑州银基冰雪酒店套票3天
万峰林2日	万峰林二日纯玩
西宁长租房	西宁短租公寓
青岛一中	青岛第一中学
佘山附近酒店	佘山 酒店
秦皇岛老虎石	秦皇岛老虎石酒店
菏泽周边	菏泽旅游
情侣情趣酒店成都	成都情侣主题酒店
南通方特水上乐园门票	南通方特探险王国
北京5天自由行	北京5日4晚自由行
福州茶亭酒店	福州茶亭公园酒店
自驾租车温州	租车温州
黑牦牛	白牦牛
苏州昆山火车站酒店	苏州昆山客运南站
佛山维也纳酒店泌冲	维也纳国际酒店（佛山泌冲店）
青岛金杉微家酒店公寓	青岛金杉微家度假公寓
金蛤岛温泉度假村	金蛤岛温泉
秦岭野生动物动物园	秦岭野生动物园门票
三亚凤凰到海洋之星	三亚凤凰岛海洋之星
成都到九寨沟直通车	成都到九寨沟车票
银川景点门票贺兰山滚钟口	银川贺兰山岩画门票
金梦	金梦酒店
 汤山	汤山度假
厦门长租酒店	厦门长租
珠海周边游两日一夜温泉	珠海温泉两天一夜
岘岛自由行	岛自由行
长沙两日游攻略	长沙两日游自由行
艺术照南宁	南宁跟拍
杭州  青旅	青年旅舍杭州
大理厘米cm民宿酒店	大理厘米
江西千户苗寨住宿	西江千户苗寨住宿
喆啡精选酒店西安	西安喆啡精选酒店
西安出发自由行	自由行西安出发
无锡梁溪区酒店	无锡梁溪区
西安南城墙门票	西安城墙南门门票
郑州市二七广场附近主题酒店	郑州主题带浴缸酒店
成都火车北站站附近的酒店	成都火车东站 
西乡到汉中	西乡到汉中汽车
恩施情侣酒店	恩施情侣主题酒店
tt touch	TT TOUCH酒店
欧洲电插头	欧洲插头
俄罗斯移动wife	俄罗斯移动wifi
全景相机	360全景相机
横店基地周边酒店	横店周边酒店
武威市人民医院	武威市教育局
日本自由行	日本 自由 行
张家界长春名宿火车站天门山店	张家界长春民宿火车站天门山店
涠洲岛门票套票	涠洲岛票
沈阳欧亚菲温泉酒店	沈阳欧亚菲温泉水世界酒店
无锡到淮南	淮安到无锡
承德技师学院新校区	承德石油高等专科学校
常州溧阳市-市区附近的酒店	常州溧阳站酒店
桔子杭州滨江大学城酒店	桔子杭州滨江江南大道酒店
厦门市波特曼酒店	厦门波特曼酒店
揭阳特美思酒店	揭阳特美思公寓
长春附近景点	长春周边旅游景点
澳门 l签	澳门 签注
山东理工大学	山东理工大学西校区
青岛至烟台火车	烟台南到青岛北的火车票
裕珑	裕珑精品酒店
西安北站停车场	西安北站附近停车场
水上乐园门票南昌	水上乐园一日南昌
三亚 香水湾	三亚香水湾酒店
张家界一日游天门山	张家界天门山一日游
弥勒红酒庄园	弥勒酒庄
名宿普者黑	民宿普者黑
烟台迎春大街	烟台南大街酒店
珠海机场接送机	珠海 机场 接送 机
雪山小筑	雪山客栈
南京南 	南京市南京南站南广场酒店
南京维也纳酒店奥	南京维也纳酒店
郡安里君澜酒店	郡安里君澜度假区
郑州汝河路小学酒店	郑州实验外国语中学附近酒店
湖坑土楼一日游	【买二送一】厦门旅游云水谣永定土楼纯玩跟团品质一日游可选小团
上海火车站维也纳	维也纳上海火车站
御温泉8人	御温泉5人
汉庭总统府	汉庭优佳总统府店
锦江之星品尚华佗	锦江之星品尚
朱家尖 悦来	朱家尖悦来度假酒店
香港一日游长洲	香港一日香港
上海亲子游玩	上海亲子游
洛杉矶接机车华人	洛杉矶接机
东京池袋酒店	池袋 酒店
漫游超人日本wif	漫游超人 日本 wifi
广州如家公寓人和地铁站	如家广州白云机场人和大街店
广州长隆海上乐园。	广州长隆水上乐园
青岛金沙滩海景名宿	青岛金沙滩景温馨家庭民宿
光谷 万豪酒店	光谷万豪酒店
温汤镇温泉门票	温汤温泉
郑州火车站回周口	郑州火车站口
青海土拔鼠	青海土拨鼠
密室逃脱青岛	青岛密室逃脱
长江索道门票北站	长江索道一日北站
泰国散拼6天5晚	六日泰国
千户苗寨一日	千户苗寨 一日游
石河子如家酒店	如家石河子北四路市政府店
杨梅坑美人鱼	深圳杨梅坑美人鱼
汉庭酒店广安门地铁站店	汉庭优佳广安门
新疆四日游	新疆喀纳斯4天
青岛新业广场	青岛体育中心
潜水捕捞	体验潜水
上海如家酒店 迪士尼	上海如家酒店迪士尼
云南巍山	巍山
锦江之星杭州湖滨店	杭州锦江之星酒店
芬兰极光玻璃屋上海	芬兰极光玻璃屋
良宿网红	良宿奢网红
澳门mgm酒店	mgm澳门
河北师范大学裕华区	河北师范大学附近的酒店
杭州美豪丽致	美豪丽致杭州
厦门附近三日游	厦门三天二晚
广州长隆野生动物世界+大马戏门票	广州长隆野生动物世界大马戏票
家美	家美酒店
广元图腾广场	广元图腾广场酒店
佛山美的鹭湖温泉	佛山美的鹭湖半山温泉酒店
首尔 上海 半自由行	上海首尔自由
新加坡春节期	新加坡春节
金华国际雷迪森广场	金华雷迪森酒店
曼嘉	曼嘉酒店
深圳伯爵精品	深圳伯爵酒店
义乌义亭	义乌义亭镇
西雅图太空针塔	西雅图太空针
urbn hotel上海	上海urbn酒店
海南候鸟	海南 候鸟
格林豪泰海口海府路	格林豪泰（海口国贸商务酒店）
白云区百信广场	白云区白云大道北2号
潜水凯恩斯	凯恩斯深潜
龚禧里·初见酒店（昆明南屏街店）	昆明龚禧里酒店 初见
锡林郭勒盟中心医院	锡林郭勒盟锡林郭勒职业学院酒店
山东大学中心	山东中医药大学
日本美食东京	日本自助晚餐东京
厦门市思明区中山路家庭套房	厦门市思明区中山路套房酒店
厦门市第五医院附近的酒店	厦门大学附属第一医院附近酒店
香格里拉导游	香格里拉向导
恩施周边旅遊景点	恩施旅游景点介绍
迪士尼上海门票一日	上海迪士尼门票一日票
日照安泰	日照安泰酒店
杭州拱墅区莫干山路附近的酒店	杭州拱墅区莫干山路酒店
云南旅游昆明石林一日游	昆明到石林一日游纯玩
云峰山温泉	云峰山温泉酒店
杭州运河塘栖雷迪森庄园酒店	杭州运河塘栖雷迪森庄园
华谊兄弟电影小镇酒店	华谊兄弟电影世界酒店
shuangzita	双子塔
武汉地铁4号线酒店	武汉地铁站酒店
曼谷学泰菜	曼谷泰菜
海口欢阁	海口欢阁酒店
达古冰川到成都	达古冰川成都出发
山东省聊城高唐县	聊城市高唐县
广州白云大道北地铁站店	广州市白云大道北酒店
常州中华恐龙园2大一小	常州中华恐龙园2大1小
领南印象园	印象园
上海迪斯尼乐园门票2大1小	上海迪士尼乐园门票1日票
芽庄海鲜自助	芽庄海鲜自助餐
皖南攻略	皖南两日游
成都沐清汤泉	成都沐青汤泉
台湾电话卡无锡	台湾电话卡
御温泉单人	御温泉双人
邻水到绵阳	绵阳到邻水
辰龙关	辰龙 关
青岛海尚海景公寓	青岛海尚海景度假公寓
广州长隆童趣乐园	广州长隆欢乐乐园
普吉珍珠岛皮皮岛一日游	普吉一日珍珠岛
哈市周边一日游	哈市一日
海南西沙群岛	海南西沙群岛旅游
澳大利	澳大利亚。
无锡一中	无锡二泉中学
珠海凤凰湾悦椿酒店晚餐	珠海凤凰湾悦椿酒店自助餐
昆明长水机场附近宾馆免费接机	昆明长水国际机场接送酒店
上饶龙潭湖	上饶龙潭湖公园
双月湾零度	惠东双月湾零度
中南无山居	中南無山居
上海闵行区和颐酒店	上海和颐
维也纳南门	维也纳步行街
广东三九脑科医院	广东省中医院
嘉善洗浴中心	嘉善洗浴
汉庭酒店天津火车站店	汉庭天津火车站新开路酒店
临沂宾馆 沂蒙路店	临沂宾馆开发区店
幸福树酒店	幸福树
普吉岛幻乐园	普吉岛水上乐园
赤峰到山西	赤峰到太原
香港无限 流量	香港境外电话卡
中山柏林酒店	中山市柏林酒店
成都融创雪世界 夜场	成都融创雪世界门票
亭院里	院里
紫金国际大酒店	紫金大酒店
呼和浩特万豪酒店	呼和浩特万豪
宜昌海洋馆	宜昌海洋世界
台山下川岛酒店码头附近	台山下川岛海边酒店
黄山风景区索道票	黄山景区门票含索道
汉室酒店	汉室
乌兰察布市	乌兰察布市中心
西安兵华清池门票	西安华清池门票
xbed互联网酒店广州	广州xbed
北京旅游规划师	北京旅游规划
攀登四姑娘山	四姑娘山三峰攀登
杭州果丁酒店式公寓蓝庭	杭州蓝庭公寓式酒店
南通狼山景区	南通狼山风景区
北京工业大学附属中学首城校区	北京工业大学附属中学(首城国际校区)
涂牛旅游	牛牛旅游
大理金梭岛酒店	大理金梭岛
深圳北速8酒店	速8酒店深圳北站
北京科技职业学院昌平区	北京昌平区第四中学附近的酒店
普吉岛网红店	普吉岛网红
历山路36号	历山路酒店
沙巴 摄影	沙巴拍
沈阳市沈阳国际展览中心酒店	沈阳国际展览中心附近的酒店
天湖茶坪	天湖茶坪精品酒店
五桂桥客运站	五桂桥
侨堂酒店	侨堂
火车票 优惠	火车票满减
上海车墩附影视城	上海车墩影视城门票
中山车站	中山汽车站
焦作情侣酒店	焦作情侣
潜山三组寺	潜山三祖寺
上海迪斯尼餐厅券	上海迪士尼 餐券
和颐至尊 滴水湖	和颐 滴水湖
附近公厕	附近的公厕
国内两日游南昌出发	二日南昌
泰国以自由行	自由行泰国
重庆乐song	重庆乐Song·天际LOFT民宿（解放碑店）
温泉清远 出发	清远水
合芜湖方特	合肥芜湖方特
珠海市珠海金湾区珠海机场酒店	珠海市机场酒店
恩施职院	恩施湖北民族学院
朝天吼附近的酒店	朝天吼住宿
七星游艇	七星游艇会
西宁去敦煌	西宁到敦煌 团
太原武宿机场附近的酒店	太原武宿国际机场酒店
中华门瓮城门票	中华门门票
乌克兰商务签证	乌克兰签证
汉庭北京西站	汉庭北京西站北广场中心酒店
天浪滔园	天浪淘园
绍兴嵊州西白山民宿	绍兴嵊州西白山
欢乐谷 学生票 武汉	欢乐谷武汉票
车票打印	打印车票
外伶仃岛1日往返船票	外伶仃岛船票往返
杭州领尚臻品酒店钱江新城店	领尚臻品酒店杭州钱江新城汽车南站店
苏梅岛六善	苏梅岛六善酒店
青岛美墅假期酒店	青岛美墅假期酒店30号海边别墅
迪士尼门票 亲子	迪士尼门票亲子票
深圳宝福田民宿	深圳福田民宿
国家美术馆新加坡	新加坡国家艺术馆
松阳温泉	松阳 温泉
南京夫子庙7天连锁酒店	南京七天连锁酒店夫子庙
泰业	泰业酒店
飞猪信用住丽江春花秋月庭院客栈今天最低价75	丽江春花秋月庭院客栈
宿州灵璧中安国际酒店	宿州灵璧县附近的酒店
月光码头	月光 码头
榆林中学	榆林高新中学
潍坊寒亭区酒店	潍坊寒亭六中酒店
三亚仁恒海棠湾(建设中)酒店	三亚市仁恒海棠湾(建设中)酒店
欧洲 流量卡	欧洲流量电话卡
如家前门店	如家前门
大明湖船	大明湖游船
苏州整栋民宿	苏州民宿独栋
杭州海康威视数字技术股份有限公司	杭州海康威视酒店
长春警察学院	长春高新第二实验学校
杭州宝盛水博园大酒店民宿	杭州杭州宝盛水博园大酒店
上海仁爱医院	上海仁济医院东院
同济大学附近酒店	同济大学四平路校区
卫东站	卫东(地铁站)
深圳宏阳酒店	深圳弘阳酒店
去哈尔滨怎么玩	哈尔滨玩
全季酒店上海浦江	全季浦江
三峡医药高等专科学校附近宾馆	三峡旅游职业技术学院
芜湖大白鲸海底世界年卡	芜湖大白鲸海底世界
腾冲接机	腾冲接机送机
福建甫田	福建莆田
日本旅游手机卡	日本旅游上网卡
峨眉山拈花溪 拈花山居酒店	拈花溪峨眉山精品民宿
双廊到大理	大理古镇到双廊
室外温泉酒店	温泉室外
杭州市杭州医学院滨江校区酒店	杭州医学院滨江校区西门
泰国丹嫩沙多水上市场和杜拉拉水上市场	泰国丹嫩沙多水上市场
眉山市成都艺术职业大学青神校区酒店	眉山市四川科技职业学院(天府校区)酒店
西北8省环游火车专列	西北五省旅游专列
湖北第二师范学院学术交流中心酒店	湖北民族大学
七天酒店黄花岗	7天黄花岗
蜈支洲岛观光车	蜈支洲岛
学生证怎么绑定	学生证
情侣双人游国内	国内情侣游
荆州市的酒店	荆州市荆州区酒店
印尼科莫多岛	印尼 科莫多
东衫坝上草原酒店	东杉坝上草原酒店
成都四川华新现代职业学院酒店	成都四川财经职业学院酒店
天津好玩的	天津好玩的地方
北帝山玻璃栈道票	北帝山门票
西塘栖	西塘栖宿精品民宿
南京日租房	日租房南京
泰州到长春	长春到泰州
香港 香格里拉	酒店香格里拉
东阳民宿	东阳 民宿
广州长隆酒店2天1晚家庭套票	广州长隆酒店2天1晚家庭
乌鲁木齐t2休息室	乌鲁木齐机场T2休息室
连云港 自驾游	连云港自驾
宝应县实验初级中学	宝应县
酒店麻将机	酒店带麻将机
巴厘岛一天游	巴厘岛一日游
温泉 四合院	温泉四合院
广州长隆野生动物世	广州长隆野生动物世界
东部华侨城6D电影	东部华侨城
郑州玩	郑州游
大疆无人机租赁 air	大疆无人机租赁air2
大理白族自治州海景酒店	大理海景酒店
晋江	泉州晋江
西安北的酒店	西安北三环附近酒店
大皇宫四面佛湄南河一日游	大 皇宫 四面 佛 湄南河 一 日 游
安顺黄果树瀑布门票二日票	安顺黄果树瀑布门票
上海黄埔区海友	上海黄浦区海友
惠州热汤温泉	惠州市温泉
成都到西双版纳旅游团	成都到西双版纳自由行
昆明出西安	昆明飞西安
昆山千灯景点	昆山千灯
青岛瑞阳路118酒店	青岛瑞阳路酒店
西宁国际青年旅舍客栈	西宁国际青年旅舍
兴凯湖酒店	兴凯湖农场酒店
泰安到南京	南京到泰安
千岛湖下姜村住宿	千岛湖下姜村
东方山水乐园夜场	东方山水乐园
峨山路如家	如家商旅 峨山路
罗蒙环球乐园套票	环球罗蒙乐园
宜宾到泸州	泸州到宜宾
布里斯班租车自驾	布里斯班租车
深圳海贼王展	海贼王深圳
安缦杭州	杭州安缦酒店
大厂温泉	大厂温泉度假村
桂林跟团游两天一夜	桂林两天一晚
西安大雁塔附近的酒店橘子	西安北站橘子酒店
东南亚签证	东南亚旅游签证
广州从化良口	广州从化良口镇酒店
杭州曼谷自由行	杭州曼谷直飞
广州体育馆酒店	广州体育中心酒店
黄山市黄山风景区西云海山庄	黄山云海山庄
朱家尖酒店南景海景公寓	海景精品度假公寓朱家尖
沈阳签证	沈阳留学签证
无无锡拈花湾住宿	无锡拈花湾住宿
长白山魔界	长白山魔界风景区门票
西夏陵一日游	西夏王陵一日游
重庆解放碑wfc观景台	重庆wfc观景台
芭提雅信不信由你	芭堤雅信不信由你博物馆
南京出发云南旅游西双版纳	云南旅游跟团15天西双版纳
绵阳飞昆明	绵阳到昆明往返
横店影视城租车	横店租车
锦江之星 深圳福民地铁站店	锦江之星深圳福民地铁站店
天露山度假酒店	天露山酒店
建国璞隐酒店 扬州	扬州建国璞隐
古羌城门票	茂县中国古羌城景区门票+观光车票
新疆北疆跟团	新疆北疆6日游
嘉兴南湖维也纳	维也纳酒店嘉兴南湖
六盘水第四实验中学	六盘水第二十三中学
仙本那白天	仙本那白
俄罗斯流量	俄罗斯国际漫游
金华禧悦瑰丽酒店	金华禧悦瑰丽
十一跟团游苏杭	跟团游苏杭
珠海长隆酒店价格	长隆珠海酒店
南奥2日游	甘南二日两日
深圳会展中心/CBD酒店	深圳体育中心酒店
苏州洞山	苏州东山
团游上海	上海旅行团
鼓浪屿五大景点联票。	鼓浪屿景点联票
宁波亲子	宁波亲子游特色体验二日
宁波海底世界	宁波海洋
大理沙溪九七之约客栈南苑	大理沙溪九七之约客栈北苑
芭提雅到王权免税店	芭提雅免税店自助餐
怀化地方好玩	怀化门票
动物园门票无锡	无锡动物园大门票
卡若拉冰川	卡渃拉冰川
武威职业学院附近的酒店	武威第十九中学
安徽宣城市泾县	宣城泾县
南昌十八中学	南昌十四中学
济南到海南飞机票	济南到海南的机票
青岛锦江之星栈桥中山路	锦江之星青岛
广东惠州金海湾喜来登度假酒店	惠州巽寮湾金海湾喜来登温泉
白云机场大巴	广州白云机场大巴
魅力湘西和宝峰湖套票	【可订当日】张家界魅力湘西vip演出票宝峰湖门票含游船环保车
梦邸品致酒店	梦邸品质酒店
珠海香洲区凤凰北附近的酒店	珠海香洲区酒店
航空港万怡酒店	航空港万怡
银川腾格里沙漠一日游月亮湖	银川出发沙湖一日游
报团两日游	跟团两日游
大庆游玩	大庆当地玩乐
境外保险日本	日本保险
永泰大漳溪	福州永泰大漳溪
围州岛	涠洲岛
西安康复路酒店	西安康复路批发市场附近的酒店
孝义出发焦作云台山两日游	郑州焦作云台山二日
二舍香格里拉	香格里拉二日
锦江之星盐城	盐城锦江之星品尚酒店
苏州伊牧精品酒店	苏州伊牧酒店
烟台火东站民宿	烟台火车站民宿
中国博物馆门票	中国国家博物馆门票
宣城中学	宣城六中
海洋绿洲好	海洋绿洲号
南京温泉一日游	南京泡温泉一日游
千寻重庆	重庆千寻
温泉度假区	温泉
游巴厘	游 巴厘
韶关太阳城	韶关太阳城碧桂园凤凰酒店
台中半日游	台中半日
深圳后海地铁站	深圳 后海 地铁 站
上海海昌海洋公园表演	上海海昌海洋公园夜场
舟山普陀区民宿	舟山的民宿
南昌秋水广场	南昌秋水广场音乐喷泉附近酒店
那曲住宿	那曲的酒店
南昌三中青山湖罗家校区	南昌大学青山湖校区
杭州去三亚旅游	杭州到三亚旅游自由行跟团游
贵阳森林野生动物园附近的酒店	贵阳师范学院
广州塔门票套票	广州塔一日套票
阳江海陵岛民宿套房	阳江海陵岛名宿
香港迪士尼乐园快速通行证门票	香港迪士尼快速通道
迪士尼官方网站	迪士尼官网
海外水下相机租赁gopro	水下相机租赁gopro
浙江舟山嵊泗列岛	舟山嵊泗岛
深圳尤克里里	深圳杨梅坑尤克里里
丽江四人团	丽江私人定制团
南京铂金黄埔	南京铂金黄埔酒店
黑河学院	黑河二中
重庆到贵州的机票	重庆到贵州机票
青年旅舍重庆北站北广场	青年旅舍重庆北站
南京999旅馆	99旅馆南京
华山北站附近酒店	华山游客中心附近住宿
普吉镇皇家P酒店	普吉岛皇家普吉城市酒店
阳朔遇龙河竹筏漂流门票船票	阳朔遇龙河竹筏漂流门票
江西修河温泉度假酒店	修河温泉度假酒店
北京儿童游乐场	北京游乐园
四川师范大学成龙校区西门	四川师范大学成龙校区
黄饶古镇贺州	贺州黄姚古镇聚雅轩
大理洱海酒店海景	大理 酒店 洱海
重庆星级酒店主城区	重庆星级酒店
济宁技师学院	济宁职业技术学院附近的酒店
镇江中学附属初中	镇江高等职业技术学校
杭州3日游	杭州3日游当地跟团游
湖北省历史博物馆	湖北博物馆馆
石舍村民宿	石舍民宿
香港送机	香港接送车
乐尔曼酒店公寓	乐尔曼精品公寓
北海维也纳	维也纳酒店北海高铁站店
上海现代博物馆	上海自然历史博物馆
杭州滨江浙二医院酒店	杭州浙二医院滨江区
大红袍景区	大红袍门票
重庆歇台子酒店	重庆歇台子
珠海水上乐园	珠海水乐园
洲际 珠海	珠海洲际酒店
上海野生动物园酒店加门票	上海野生动物园酒店票
绵阳旅游团	绵阳跟团游
绵阳方特周边酒店	绵阳方特附近的酒店
大理海东镇理想邦	大理 理想邦
日本个人签证 旅游	日本签证
自由家黄山齐云营地树屋世界	黄山自由家齐云营地树屋世界
Theb名古屋酒店	the b 名古屋酒店
连云港云海山庄海景酒店（海滨浴场店）	连云港近海山庄
城都到温州	成都到温州
中围移动香港储值卡	移动香港电话卡
国际会展图卡思酒店 (汕头会展中心苏宁广场店)	汕头国际会展图卡思酒店
宁波东钱湖纪家庄开元度假村木屋	宁波东钱湖纪家庄开元度假村
古运河船票	古运河
全季酒店上海动物园	全季上海野生动物园酒店
定西市一中	定西市人民医院
三亚 亚龙湾 酒店	三亚亚龙湾酒店
河北石家庄	河北省石家庄
广州珠海两个长隆	长隆广州珠海
成都碧家酒店	成都碧家
郑州 昆明	昆明郑州
北京刘家窑地铁站附近的酒店	北京刘家窑附近酒店
烟台幼儿师范高等专科学校	烟台工贸学校
龙脊梯田住宿	龙脊梯田酒店
东莞豪门大酒店	东莞豪门大饭店
西藏跟团4天	西藏跟团游4天3晚
广州天通建国	广州建国酒店
西岭雪山门票花水湾温泉	西岭雪山花水湾温泉
到上海一日游	上海一日夜游
锡林郭勒草原	锡林郭勒
宁海温泉酒店	宁海温泉门票
地址：\n\n广东省阳江市江城区闸坡镇北洛秘境度假酒店\n\n	广东阳江江城闸坡镇北洛秘境度假酒店
南京网红打卡点	南京网红打卡景点
泰安连锁酒店	泰安六中
伊犁到喀纳斯	乌鲁木齐到喀纳斯交通
珠海横琴名宿公寓	珠海横琴1加1主题公寓
维也纳酒店(杭州武林广场店)	维也纳酒店杭州西湖文化广场
昆明嵩明	昆明嵩明县
千岛湖绿城喜来登自助餐	千岛湖喜来登自助餐
莫泰酒店南京	莫泰南京
深圳维美娜酒店公寓世界之窗店	深圳维美娜酒店公寓(深圳世界之窗店)
中建雁栖湖景酒店	中建雁栖湖
成都市内包车一日游	成都包车一日
桔子精选文三	桔子精选文三路
上次迪士尼乐园	迪士尼迪士尼乐园
惠州双月湾西班牙小镇一期	惠东双月湾西班牙小镇
三亚酒店加门票自由行	三亚门票加酒店
如家杨庄	如家酒店杨庄
北京中粮·祥云小镇酒店	北京祥云小镇酒店
昆明一石林一日游	昆明石林二日
常州淹城野生动物园门票特价	江苏常州淹城野生动物园门票 淹城动物园电子票常州动物园团队票
台山颐和温泉城附近的酒店	台山颐和酒店温泉
西畈	西塱
广东金融学院酒店	广东工商学院
十一亲子	十一亲子游
沈阳 三亚	三亚沈阳
南昌狮子峰门票	南昌梅林狮子峰
分界洲岛海鲜自助餐	分界洲岛自助餐
三亚市海韵酒店	三亚湾路海韵酒店
威海一日	威海环海路一日游
泰国sim卡10天	泰国happy10
钓鱼三亚	三亚游艇租赁
清远佛冈碧桂园温泉凤凰湾温泉	清远温泉￼佛冈碧桂园温泉度假别墅
下單	下 单
三亚游艇出海大游艇	三亚游艇出海
澳门zizhucan	澳门自助餐
全季酒店南山路杭州西湖店	杭州全季酒店西湖南山路
陕西服装工程学院	陕西国际商贸学院附近的酒店
札幌周边游	札幌 周边 游
千岛湖洲际度假酒店儿童乐园	千岛湖洲际儿童乐园
威海 沙滩	威海沙滩
西昌的门票	西昌一日
上饶华米轻居	上饶华米酒店
东山铜陵镇 马銮湾吃饭	东山铜陵镇马銮湾
半屏山景区	半屏山门票
多弗度假酒店	多弗度假
广州私立华联学院酒店	广州华立学院附近的酒店
泰国手机号卡	泰国happy卡
杭州市如家酒店	杭州市如家精选酒店
上海野生动物园老年票	上海野生动物园门票 年票
希腊 扎金索斯岛 沉船湾观景	希腊沉船湾一日游
西安己拾己酒店	西安己拾己设计师酒店（曲江大雁塔会展中心店）
昆明raw酒店	昆明rawhotel
南通方特水上乐园儿童门票	南通方特欢乐世界
黄山看日出攻略	黄山日出
神龙架雅竹大酒店	神农架雅竹大酒店
广州铂悦酒店	广州 铂 悦 酒店
南京科技岛	科技南京
迪拜 手机卡	阿联酋迪拜电话卡
广州白云机场T2航站楼	广州白云国际机场T1航站楼附近的酒店
日本滑翔伞	滑翔伞日本
名宿深圳	深圳 民宿
汉庭瘦西湖	汉庭优佳瘦西湖
白鹿千寻	白鹿千寻酒店
澳门酒店双十一	澳门酒店活动特价
西岸青雅	西安青雅
佛山第四中学	佛山实验中学
喀纳斯扎拉特小木屋	喀纳斯小木屋
中山港到深圳机场船票	中山港港至深圳港船票
淹城野生动物园门票家庭票	淹城野生动物世界
莫干山能带宠物的民宿	湖州莫干山民宿可带宠物
上海浦东喜来登自由	上海浦东喜来登由由
武汉的莫泰酒店	武汉莫泰
茶田吾舍	茶田吾舍雅舍
杭州开元森泊度假酒店湖景房	杭州开元森泊度假酒店亲子房
泰国签证 广州 	泰国签证加急广州送签
良九	良九酒店
东京自助	东京 自助
杭州农家乐民宿	杭州农家乐
惠东双月湾自在公寓	惠州惠东双月湾自在公寓
乌镇曼途精品民宿	乌镇西栅曼途精品民宿
韩国旅游签证杭州	韩国签证旅游
西安BIG HOUSE骊语阁温泉庭院 小筑酒店	西安骊语阁温泉
爱琴海国际温泉	爱琴海温泉酒店
大理客栈洱海	大理洱海海边客栈
大理洱海金沙半岛	大理金沙半岛海景酒店
绍兴柯桥景点	绍兴景区
万宁艾美套餐	万宁艾美酒店
平潭龙岩山庄	平潭红岩海滨山庄
兰州新区情侣主题酒店	情侣酒店主题兰州
象山靠海	象山海边
甘肃跟团游	甘肃跟团
无锡三亚	无锡三亚自由行
蜀南竹海车	蜀南竹海
庐山西海温泉度假村	庐山西海温泉假日酒店
卧龙山	卧龙山景区
昆山虹桥医院	昆山市第一人民医院
河南省博物院附近酒店	河南省文学院
上海迪士尼度假区橘子水晶酒店	上海迪士尼桔子水晶
上海杨浦区长海医院酒店	上海长海医院
余姚市人民政府	余姚市政府
红树林 	红树林森林
如家上海世纪公园店	如家酒店上海世纪公园店浦建路
玉龙雪山羽绒服租	玉龙雪山租衣服
张家界森林公园	张家界国家森林
舟山普陀山景区门票	浙江普陀山门票
蓬莱至哈尔滨	哈尔滨到蓬莱
威海三日游跟团游	威海跟团游3日游
诸城到招远	招远到诸城
新豆苑酒店	新豆苑
牡丹江市内游玩	牡丹江的当地玩乐
长沙维也纳酒店芙蓉广场	长沙维也纳国际酒店五一广场店
云上四季 昆明穿金路店	云上四季昆明火车北站地铁站店
夏威夷跟团	夏威夷跟团游
石林九乡一日游小团	石林九乡一日游门票
清远美林湖度假别墅	清远美林湖温泉度假别墅三房
长隆欢乐乐园	长隆欢乐
上海吴淞口国际邮轮港码头wifi	上海吴淞口国际邮轮港码头
黄山排云亭宾馆山上	黄山排云楼宾馆
淮安柏曼酒店	淮安柏曼
福建医科大学上街	福建医科大学附属第一医院
四川 租车	四川成都租车自驾游
蜈支洲尾波冲浪	蜈支洲冲浪
武汉华中师范大学附近快捷酒店	武汉酒店华中师范大学
全季 太仓	全季酒店太仓
上海丽思卡尔顿酒店	上海浦东丽思卡尔顿酒店
柞水住宿	柞水酒店
99优选酒店天津天塔地铁站店	99优选酒店（天津之眼古文化街店）
上海普陀山自由行	上海普陀山两日游自由
广州火车东站酒店	广州市东站
如家驿居上海浦东南路世博店	如家驿居酒店 上海世博
四平景点	四平旅游景点
巴伐利亚庄园室内温泉	巴伐利亚庄园温泉
上海车墩镇附近的酒店	上海市车墩镇酒店
清远古龙峡两日游	清远古龙峡两天游
海龟自然保护区门票	海龟自然保护区
西昌桔子	西昌橘子酒店
方庄	方庄体育公园
长白山万达小镇滑雪	长白山万达滑雪套票
云南保山机场接送腾冲	腾冲接送机
五号停机坪广场	5号停机坪购物广场
北京两天	北京两天游
拈花小镇门票	拈花湾大门票
sim卡  欧洲	欧洲电话卡4g
云凯酒店广州	广州云凯酒店
西安壶口瀑布一日游门票动车	西安壶口瀑布一日门票
绍兴租车游	绍兴旅游租车
惠州酒店海边	惠州沙滩海景房
香港过关送签	送香港过关签
天津郦枫酒店	天津郦枫酒店五大道
乌镇 别墅	乌镇民宿别墅
鳌山滑雪票	鳌山滑雪
广灵酒店	广灵大酒店
廉江市附近的酒店	广东廉江酒店
包头东站	包头东火车站
泉州市泉州师范学院酒店	泉州市泉州经贸职业技术学院酒店
厦门租摩托车自驾	厦门租山地车
萤火虫夜游	萤火虫一日游
千岛湖亚朵	千岛湖亚朵酒店
松果酒店（郑州东风路店）	松果酒店(郑州文化路店)
隆宝雅逸酒店	雅逸酒店
格林豪泰秋涛路店	格林豪泰杭州秋涛路商务酒店
杭州灵隐附近酒店	杭州灵隐寺附近的酒店
桂林希尔顿酒店	桂林希尔顿欢朋酒店
芜湖方特旅游订票	芜湖方特旅游区
贵阳迪士尼	贵阳迪士尼乐园
香港 流量卡	香港不限流量电话卡2天
香港迪士尼乐园晚套餐	香港迪士尼乐园晚餐餐券
北京周边2日自驾游	北京周边二日自驾
天台长途汽车站	天台客运站
重庆交通卡	重庆公交
金威宾馆	金威商务宾馆
凤心竹阁客栈	凤凰古城心竹阁客栈
西安陕西历史博物馆讲解大赛冠军	西安陕西历史博物馆讲解大赛
博鳌水上乐园门票	博鳌水上乐园
迪士门票上海	上海迪斯尼迪斯尼门票
北京湾子 地铁站 酒店	北京湾子(地铁站)酒店
澳门直达广州直通车单程	澳门 直达 广州 直通 车 单程
仙螺岛海上索道	仙螺岛缆车
吉安火车站附近的酒店	吉安站
临沂市泰盛广场酒店	临沂泰盛广场附近酒店
阳江海陵岛海边别墅	阳江市海陵岛别墅
梅园悦竹	梅园·悦竹酒店
普吉丛林飞跃	普吉skyline丛林飞跃
珠海外伶相思岭	珠海相思岭
北厍	北礵
广州创融乐园雪世界	广州融创雪世界乐园
钟山苏宁高尔夫	苏宁钟山国际高尔夫酒店酒店套餐
跟团滑雪	滑雪旅行团
合肥职教城	合肥职教城酒店
贵安欢乐水世界亲子	贵安水世界欢乐世界
太空舱酒店	太空舱
澳门自助餐酒店	澳门 自助餐
呀诺达电瓶车多少钱	呀诺达电瓶车
北京当地游	北京市内游
济南泉城极地海洋世界当日	济南泉城极地海洋世界一日
武汉雄楚国际大酒店	武汉雄楚国际
南京国际博览中心酒店周边	南京市南京国际展览中心酒店
阜阳的酒店格林豪泰火车站	阜阳格林豪泰会展中心店
贵阳麓枫酒店	丽枫酒店·贵阳北站店
上海金桥国际商业广场	上海金桥国际商业广场酒店
贵阳黄果树地址	黄果树贵阳
连云港速8	连云港速8酒店
静庭民宿	静庭时尚民宿
小梅沙海滩	深圳小梅沙海滩门票
新加坡 票	新加坡门票
如家精选酒店 绍兴人民西路	绍兴如家
青岛苗岭路酒店	青岛江西路二中分校附近的酒店
上海迪斯尼门票团票	上海迪士尼票门票
沈阳3日游	三日游沈阳
大理双廊山居海魅海景客栈	大理山居海魅海景客栈
非常客栈南昌	南昌非常客栈
澄江 海豚湾	澄江海豚湾
喀纳斯7日游	喀纳斯七日游
三亚湾天涯区兰海花园	三亚 湾 天涯 区 兰海 花园
婺源北线	婺源一日游北线攻略
拉市海 茶马古道	拉市海骑马
韶关南华寺附近的温泉	韶关南华寺温泉
阆中故城	阆中古城
大连红旗西路附近的酒店	大连市联合路(地铁站)酒店
佛山 万达	佛山南海万达
杭州西溪国家湿地公园攻略	杭州西溪湿地公园攻略
麗枫酒店·广州花都广场店	丽枫酒店广州花都广场店
广州南到顺德站	顺德站到广州南站
湖北房县天悦温泉	房县天悦温泉酒店
香格里拉租车自驾游免押	香格里拉租车自驾游
韩国江原道滑雪	韩国江原道滑雪场
舟山三日游苏州出发	舟山三日游
日本探亲签重庆	日本签证探亲重庆
南宁至防城港高铁	南宁到防城港
百色市第三中学	百色市第一小学
上海迪士尼可以寄存行李吗	上海迪士尼度假区行李寄存
上海 加拿大签证	签证加拿大
江浙沪周边游上海出发	江浙周边游上海出发三日
庐山侠隐	庐山侠隐山居
龙凤山庄世界梦幻酒店	龙凤山庄梦幻酒店
比利时荷兰	法国荷兰比利时
黄陂区酒店	黄陂区
宁波象山石浦镇	宁波象山石浦酒店
南京站汉庭	南京的汉庭酒店
上海迪士尼门票尊享	上海迪士尼乐园尊享票
西安咸阳国际机场朗悦商务宾馆	咸阳西安机场怡悦商务宾馆
巽寮湾华家班门票	惠东巽寮湾华家班
广州丰盈酒店	广州丰盈
广州从化广东温泉宾馆别墅	广州从化广东温泉宾馆
潮汕跟团3日游	潮汕3日游
光谷公寓	光谷天地酒店公寓
佛山顺德长鹿农庄酒店早餐	佛山顺德长鹿农庄酒店温泉套票
营口思拉堡虹溪谷温泉假日酒店	营口思拉堡虹溪谷欢乐大世界
维利亚	维利亚酒店
贵阳东站车站	贵阳北站高铁站
民宿上海徐家汇	上海徐家汇民宿
柚子电竞酒店	桔子电竞主题酒店
昆山南站到虹桥机场	昆山到虹桥机场
玫瑰hu	玫瑰花
沙井客运中心	沙井中心客运站
惠州潜浮	惠州浮潜
台州温岭石塘古镇	台州温岭市石塘民宿
海陵岛匣坡风帆	海陵岛风帆
福建省体育中心游泳	福建体育中心
阳泉市第一人民医院	阳泉市客运总站
重庆武隆天坑地缝两日纯游	重庆武隆天坑地缝两日游
贺州沐足	贺州温泉
南昌市双港酒店	南昌市双港(地铁站)酒店
合肥站酒店	合肥站
香港一日游包干	香港游一日
海底世界山东	山东海洋馆
云南跟团游五天四晚	云南跟团游5天
成都atinn在酒店	成都ATINN·在酒店
旧金山自由行10	旧金山自由行
芜湖方特东方神话白天门票	芜湖方特东方神话门票
大理丽江香格里拉泸沽湖四天	大理丽江泸沽湖香格里拉
深圳南头古城	深圳南头古城附近的酒店
普者黑两日游攻略	普者黑纯玩两日游
常州万怡	常州万豪
巴厘岛spazen	巴厘岛spa
广西巴马寿乡大酒店	巴马寿乡国际大酒店
广州东站去香港直通车	广州去香港直通车
杭州至海南的机票	杭州到海南往返机票
海口酒店机场	海口机场附近
惠州港口双月湾海角1号酒店	广东惠州双月湾海角6号
惠州洲	惠州惠东
青岛金沙滩民宿三室	青岛金沙滩民宿三居室
绍兴咸亨大酒店附近酒店	绍兴咸亨大酒店绍兴
芭提雅黄金海	芭提雅黄金
送机服务杭州	送机杭州
青岛藏马山温泉票	青岛藏马山温泉
绿地康养	绿地康养酒店
潍坊市弘润融汇温泉酒店水乐园	潍坊弘润融汇温泉水世界
郸城县新汽车站	郸城县中心站
台北市区及周边 包车	台北周边包车
武汉同济生殖医学中心酒店	武汉同济医院酒店
长鹿农庄门票2大1小	佛山长鹿农庄门票2大2小
毛里求斯 亲子	毛里求斯亲子旅游
昆明星耀体育馆附近的酒店	昆明星耀路附近酒店
永安到广州	广州到永安
上海杭州苏州无锡南京攻略	上海杭州苏州无锡南京
贵阳到福建飞机	江西到贵阳飞机
山西好玩的	山西附近游
石家庄鹿泉区实验小学	石家庄理工职业学院
游轮 黄浦江	黄浦江游轮
长白山万达滑雪场门票	长白山万达滑雪场一日
临朐石门坊门票多少	临朐石门坊门票
上海杜沙夫人腊像	上海杜莎夫人蜡像馆
杭州火车东站酒店	杭州城站火车站
初心精品酒店	初心酒店
黄果树瀑布门票	黄果树瀑布门票预约
宿州市	宿州市迎宾大道88号
合肥市黄山大厦	合肥黄山大厦城市酒店淮河路步行街店
淮南市淮南站酒店	淮南市淮南南站酒店
嘉兴西塘民宿	嘉兴西塘名宿
青海跟团纯玩游5天4晚含机票	青海旅游自由行5天4晚
三亚当地参团跟团四天三晚	三亚跟团4天3晚
潍坊至北京	潍坊北到北京
冰岛保险	冰岛 保险
漳州东山岛的酒店	漳州东山岛酒店
上海浦东国际机场t2酒店	上海浦东机场t2
越南wifi南宁自取	越南wifi 南宁
北京汉庭东坝酒店	北京汉庭酒店
军师博物馆	军事博物馆
广州白天鹅宾馆下午茶	广州白天鹅宾馆早茶
绵阳雅艺文化酒店	绵阳雅艺酒店
步行街厦门	厦门步行街
杭州到上海	杭州至上海
峰巢网客	网客宾馆
华轩里酒店 广州珠江新城店	华轩里酒店广州
竹叶亭	竹叶 亭
新乡宝泉风景区门票自架游	新乡河南宝泉旅游门票团购
长沙meland	meland 长沙
杭州千古情门票	杭州 千古 情 门票
慈溪市汉庭观海卫店	慈溪观海卫酒店
伦敦眼和泰晤士河	伦敦眼泰晤士河
送机服务长沙	送机长沙
淮安高沟镇附近的酒店	淮安高沟镇
亚庇j酒店	亚庇酒店
苏州园林拙政园门票	苏州 园林 拙政园 门票
佘山艾美	艾美佘山
三亚别墅名宿	三亚名宿别墅
漫城酒店重庆北站	重庆漫城艺术酒店
河內到下龍灣	河内 到 下龙湾
广州小蛮腰观光塔酒店	广州塔小蛮腰酒店
临安温泉度假	临安 温泉
阿维尼翁一日流	阿维尼翁一日
万鸟岛快艇	万鸟岛船票
牛町民宿	牛町民宿酒店
镇北堡门票	镇北堡影视城
五台山民俗客栈	五台山客栈
无锡市中心民宿	无锡民宿复式
厦门一日	厦门旅游一日游
武汉速7连锁酒店徐东一路店	武汉速7连锁酒店徐东店
佛山保利洲际酒店自助餐	佛山保利洲际酒店自助晚餐
德天瀑布通灵大峡谷	德天瀑布通灵大峡谷两日游
广州美嘉华酒店	广州白云区美嘉华
大洋路2日	墨尔本大洋路二日
上海崇明岛两日游	上海崇明岛两日一夜
武义民宿一栋	武义最好的民宿
四川租车	四川租车自驾游
古北水镇无边泳池	古北水镇泳池
燕郊到北京东	北京燕郊
湖州莫干山一日游	莫干山1日游
惠州红海湾别墅	惠州红海湾二期别墅
深圳大鹏较场尾南栖客栈	深圳较场尾南栖客栈
sim卡taiguo	普吉岛电话卡
国际行李额购买	行李额购买国内
北京八王坟长途汽车站	北京八王坟汽车站
三亚网红地	三亚网红
迪斯尼酒店套票	迪斯尼双人双日门票
常州恐龙人俱乐	常州恐龙人
南京路附近民宿	南京 路 附近 民宿
龙门南昆山居温泉度假酒店	龙门南昆山居优选温泉度假别墅
大连市中心	大连市中心酒店
东部华侨城 大侠谷	东部华侨城大侠谷门票
齐齐哈尔万达民宿	民宿短租齐齐哈尔
西安海底捞火锅	西安钟楼海底捞火锅
南京全季夫子庙	南京全季酒店夫子庙
青城山套票	青城山门票含索道
俄眉山一日游	峨眉山一日游
云南旅游专列	高铁旅游环线专列云南
稻城亚丁格措木	稻城亚丁木格措
aida自由潜	aida自由潜水
翁安薰衣草一日游	薰衣草一日
深圳龍華	深圳 龙华 酒店
苏州 度假	苏州度假
嫩江的酒店	嫩江大酒店
维也纳汕头	汕头维也纳酒店
威尼斯贡多拉游船(duplicatekey1)	威尼斯船
六盘水乌蒙大草原农家	六盘水乌蒙大草原
南宁雅斯特酒店万象城店	南宁酒店雅斯特
游泳班成人	成人游泳
同安军营村	同安军营村86号
重庆上新街	重庆上新街的酒店
极地海洋世界青岛	青岛极地海洋
邯郸市第十四中学	邯郸市第一中学
上海淮海中路酒店	上海淮海中路
全季文昌阁	文昌阁全季
榕树国际	榕树酒店
安徽黄山南门住宿	黄山南大门附近的住宿
合肥至庐江	合肥到庐江
青海湖敦煌可可西里包车	青海湖敦煌包车
新山乐高乐乐园	乐高乐园新山
南京汤山豪华型	南京汤山豪华
融创体育世界卡丁车	融创乐园卡丁车
青岛电影院	青岛电影
一日游普吉岛	普吉一日游浮潜
桂林两天一夜	桂林两日一夜
厦门 长春	厦门长春
上海维也纳国际酒店高科东路店	上海维也纳酒店国家会展中心店
景德镇陶艺街附近酒店	景德镇陶瓷大学附近酒店
沈阳市区游玩	沈阳市区旅游景点
澳门餐饮券	澳门 餐饮 券
三亚市海棠湾君悦大酒店	三亚海棠湾君悦酒店套餐
泉州火车高铁站附近的酒店	泉州火车站酒店
洞头九珑湖度假	洞头九珑湖度假酒店
杭州浙二酒店	杭州浙二
厦门万豪酒店及会议中心	厦门万豪
内江到荣昌	内江到隆昌
如家北京新街口	如家-北京新街口地铁站店
厦门海屿海景公寓	厦门海景酒店公寓
兰州甘肃省中医学院附近的酒店	兰州甘肃农业大学附近酒店
亚航行李托运票巴厘岛	巴厘岛亚航行李托运
九寨沟 成都出发	成都到九寨沟旅游
云南旅游6天纯玩	云南旅游6天5晚纯玩
小径湾花样年华	华润小径湾花样年华
扬州 亲子	扬州亲子游
汉庭上海漕河泾古北店	汉庭上海漕河泾漕宝路酒店
自由行上海迪士尼北京出发	北京到上海迪士尼跟团
三亚小脚丫家庭旅馆	三亚小脚丫客栈
重庆至宜昌客轮	轮船宜昌重庆
喀什步行街酒店	喀什商业步行街
大邑圣索亚酒店	大邑圣索亚
希尔顿 文昌	文昌希尔顿
酒店加南昌万达主题乐园门票	南昌万达主题乐园酒店
澳门威尼斯人度假村酒店	澳门威尼斯人度假村
上海颐和至尊	上海中山公园和颐至尊酒店
长春怡家酒店	长春怡家时尚宾馆
湖南长沙张家界旅游6天5晚	长沙张家界跟团游6天5晚
巴彦淖尔市临河区	巴彦淖尔临河区
宝鸡汽车南站	宝鸡站
大连跟团四日三晚亲子游	大连四日游
濮阳阿尔卡迪亚酒店	濮阳 阿尔卡迪亚
北京天文馆门票单独	北京天文馆门票
澳门免税店	澳门免税
云南昆明丽江大理八天七晚双飞双动	云南昆明丽江大理八日
武汉市内yiriyou	武汉市内一日游
咖咖电竞主题宾馆	电竞主题宾馆
成都团建	成都周边团建
青岛金沙滩附近酒店	青岛市金沙滩酒店
荣成倪氏海泰度假酒店	威海荣成倪氏海泰度假酒店
重庆到岳阳的船票	岳阳到重庆船票
西安兵馬俑	西安兵马俑 
马尔代夫芙拉薇莉岛	马尔代夫美露丽芙岛
潼关县酒店	潼关县旅店
情人到	情人岛
运城到上海	上海到运城
火山岛自由行	火山岛小团
贵阳至黄果树	贵阳到黄果树
大连一日游出海钓鱼包船	大连一日游出海游艇
台湾纯游玩	台湾游玩
大连滨海路附近的酒店	大连经济技术开发区附近的酒店
宁波市宁波大学东校区酒店	宁波大学旁边酒店
圣象天门一日游	圣象天门一天
大连到西安机票	大连到西安的机票
云南边境线游	云南边境游
三亚亚特兰蒂斯酒店直播	三亚亚特兰蒂斯直播
苏梅岛四季酒店早午餐	苏梅岛四季酒店
广州曼谷	泰国广州
珠海 旅拍	珠海跟拍
广州柏曼酒店南方医院	广州南站柏曼酒店
海口湾恒大	海口恒大外滩
咸宁站	咸宁南站附近的酒店
拙政园攻略	拙政园
西安市西安交大一附院酒店	西安市西安体育学院酒店
河源希尔顿精品公寓	河源希尔顿公寓
香港迪斯尼两日门票三合一餐券	香港迪斯尼门票三合一餐券
西塘七号	西塘七号客栈
安徽宏村	宏村景区内酒店
普吉岛西蒙人妖	西蒙人妖秀
长沙民宿家庭	长沙民宿两房
丹霞山附近	丹霞山住宿
南京正方中路附近的酒店	南京北京西路附近的酒店
开元森泊度水乐园	开元森泊度假酒店水乐园
西安到亳州	亳州到西安
银座佳驿枣庄文化路店	银座佳驿枣庄解放路人民医院店
垫江丰都一日游	丰都一日
安吉雲中溪	安吉民宿云中溪
南奥海景房	南澳海景房
清远漂流 深圳	深圳漂流
洞头海景一号	洞头海景
合肥潮漫酒店	潮漫酒店合肥
白云机场胶囊旅馆	机场胶囊旅馆
上海迪士尼一日日游上海迪斯尼	上海迪斯尼一日游门票
4天3晚游轮	游轮4天3晚
斯米兰群岛两日	斯米兰二日游
中青旅北京	北京中青旅
佳木斯雅居	佳木斯雅居酒店
麗枫酒店·广州东晓南地铁站店	丽枫酒店广州
海丰贡召峡	海丰召贡峡漂流
维斯特滑雪场	维斯特雪场
武汉市吴家山第二中学	武汉市洪山实验外国语学校
菏泽曹县汽车站酒店	菏泽曹县酒店
江西农业大学附近的宾馆	江西农业大学
凤凰古城旅游	凤凰古城攻略
移动国际流量	中国移动境外流量
珠海步行街	珠海商场
芭提雅哪个酒店有无边泳池	芭提雅酒店无边泳池
江汉大学文理学院新校区	江汉大学文理学院
上海南京路桔子酒店	上海桔子
将军澳	將軍澳
珠海长隆动物园	长隆野生动物园珠海
秦皇岛平水桥公园附近的酒店	秦皇岛茂业百货附近的酒店
青州的民宿	青州民宿
太原出发北京2日游	太原北京二日
玉溪古荔	玉溪古荔园
秦皇岛市碧螺塔酒店	秦皇岛碧螺塔附近的酒店
庐山景区酒店	庐山风景区酒店
曼谷清迈无边泳池	无边泳池曼谷
西宁出发包车	西宁包车
h酒店 郑州航海路店	H酒店郑州
香河服务区	香河汽车站
济南大明湖站	济南大明湖酒店
四川合江到泸州的车票	合江到泸州的车票
云南西双版纳旅游5天	云南旅游西双版纳5天
汉庭上海罗湖路	上海路汉庭
北京市区一日深度游	北京一日市区游
日照至重庆	日照到重庆
青岛市中铁-青岛世界博览城酒店	青岛市青岛国际博览中心酒店
武汉酒店单人间	武汉双床房酒店
青岛海边度假别墅独栋	青岛市青岛海边别墅
乐山当地一日游乐山出发	乐山一日游 
新加坡出发泰国	泰国新马泰
山水艺宿	山水艺宿酒店
普陀山三日游	普陀山当地跟团3日游
迪斯尼提前入园	迪斯尼免排队
柳州中环酒店	中环酒店柳州
四川新华电脑学院	四川民族学院
长白山5日	长白山旅游5天
栢	12306￼
桂林跟团游内江出发	丽江桂林跟团游
芭提雅人妖接车	芭提雅人妖接送
乐清慢方舍	慢方舍 乐清
程星	程星酒店
沙井格兰云天	沙井格兰云天大酒店
拉萨门票	拉萨纳木措门票
花水湾 亲子	花水湾亲子酒店
青岛名都凯来酒店	青岛凯来大酒店
川大九远桥川	川大九眼桥川
中原影视城	中原影视城门票
广州长隆水上乐园门票女士票	广州长隆水上乐园女士票
广西外国语学院附近的酒店	广西民族师范学院酒店
无锡7天	7天连锁酒店无锡高铁东站店
中国科学院西双版纳热带植物园夜游	中国科学院西双版纳热带植物园商圈
brandy	brandy 
大理丽江两日	大理丽江二日游
涠州岛跟团游	涠洲岛跟团游
爱堡乐园	爱宝乐园
英国火车票折扣	英国火车票
梅陇出发跟团游	跟团游
自贡锦江之星酒店	锦江之星自贡同兴路店
丽江希尔顿花园	丽江实力希尔顿花园酒店
普吉 蜜月岛登岛	普吉蜜月岛
庐山西海柘林湖	柘林湖门票
上海南京路国际青年旅行舍	上海南京路青年旅舍
辽阳的宾馆	辽阳火车站
莫干山萤火虫森林	莫干山萤火虫基地
新加坡旅行保险	新加坡旅游保险
珠海玲仃岛船票	珠海海岛外伶仃岛船票
呼伦贝尔大草原亲子	呼伦贝尔草原
龙脊梯田回桂林	桂林龙脊梯田
西双版纳旅游2人	西双版纳3天
佛山汽车总站	佛山火车站
南京柏纳酒店	柏纳南京
南京 夫子庙 酒店	南京夫子庙地区附近的酒店
汕头南澳岛交通	汕头南澳岛
海友酒店深圳会展中心店	深圳海友
uprince	prince
幸福里壹号酒店	幸福里壹号
深圳湾口岸过香港的巴士	深圳 香港 大巴
火塘精品酒店古北水镇	古北水镇火塘酒店
新加坡地铁站点	新加坡地铁站
境外购买旅游保险	境外旅游保险
芭堤雅海底世界	芭提雅海底世界
眉山瓦屋山风景区	眉山瓦屋山国家森林公园
珠海长隆海洋王国 门票	珠海长隆海洋王国的门票
贵州游六日五晚	贵州六天游
亚龙湾华宇迎宾	华宇亚龙湾迎宾馆
雅苑	雅 苑
苏州乐园	苏州乐园的门票
罗郎楠	曼谷正宗暹罗郎楠酒店
深圳湾红树林公园	深圳湾公园红树林
黄山门票加宏村门票	黄山门票宏村门票
see color高空江景酒店	see color高空江景
上海 迪斯尼 两日票	上海迪士尼两日门票
跨年珠海长隆	珠海长隆海洋王国
阿布扎比机场酒店	阿布扎比机场内酒店
大堡礁一日游直升机艾	大堡礁直升机半日游
跟团游深圳	深圳跟团游
丽水云和天籁	丽水云和民俗
莫干山帐篷酒店	莫干山帐篷
厦门南	厦门北
莎车到库尔勒	库尔勒到莎车
杭州野生动物园年票	杭州野生动物园年卡
泰融大酒店	泰融国际酒店
上海汉庭优家酒店	上海汉庭优佳酒店
毕棚沟住宿	毕棚沟酒店
福州 青旅	福州青年旅舍
五一旅游成都	春节旅游成都
南山攻略	南山一日游
萧山机场到上虞	上虞到萧山机场
博斯腾	博斯腾酒店
日本二次签证	日本签证多次
汉庭回民街	回民街汉庭
绍兴袍江酒店	绍兴 袍江
西安长乐坡	西安长乐坡 地铁站 酒店
遂宁 死海	遂宁死海门票
武汉汉口火车站地铁站附近酒店	武汉汉口火车站地铁二号线酒店
日本签证北京自由	日本签证北京
sohostel婺源设计青旅	sohostel婺源設計青旅
郑州日租房	郑州短租房
花水湾温泉别墅酒店	花水湾温泉度假别墅
横琴湾当地玩乐	横琴湾
泰国happy卡 石家庄	泰国 happy 卡
3D影院	3d电影院
甘肃青海飞猪	飞猪专线青海甘肃
西双版纳 酒店	酒店西双版纳
成都吾栖居民宿	成都栖居民宿
崇礼太舞滑雪小镇	张家口崇礼太舞滑雪小镇
心斋桥e青年旅馆	心斋桥青年旅馆
敦煌沙漠穿越露营基地	敦煌沙漠露营基地
太平山缆车加摩天轮	太平山顶缆车摩天轮
怀化凤凰古城车	怀化南站到凤凰古镇
菲律宾globe电话卡 不限流量	菲律宾globe电话卡 无限流量
惠州碧桂园温泉度假酒店	惠州碧桂园温泉酒店
沈阳旺角万达精品酒店式公寓	沈阳北一路万达公寓
西宁青海湖敦煌	甘肃西宁青海湖茶卡盐湖敦煌
顺德大良东城酒店	顺德大良步行街
nigulat	尼古拉特斯拉
桂林阳朔十里画廊景区附近酒店	阳朔十里画廊酒店
周口太康住宿宾馆	周口太康县
西藏航空随心飞	西藏航空直营店
龙之梦自驾区	龙之梦自驾门票
阳江3房一厅	阳江2房一厅
苏州市相城区	苏州市相城区天虹广场
菲利宾流量	菲律宾流量充值
日本签证信用卡	日本签证 信用卡
昊丽酒店杭州市西湖区	昊丽酒店 杭州火车东站店
文昌 酒店	海南文昌
惠州一点公寓	惠州壹点国际公寓
惠州双月湾檀悦都喜天丽度	惠州双月湾檀悦都喜天丽度假酒店美食
大连圣亚海洋世界附近旅店	大连圣亚海洋世界宾馆
鞍山千山风景名胜区附近的酒店	鞍山市千山风景区酒店
阜阳颍州区政府附近的酒店	阜阳颍州区酒店
火影忍者.	火影
淮北到日照	日照到淮北
行李托运购买	购买托运
托运行李额购买国航	托运行李额购买海航
广州去哈尔滨	广州到哈尔滨团
南武当山滑雪场	南武当山滑雪
咸阳机场附近酒店	咸阳机场t2附近酒店
珠海长隆海洋王国海底房	珠海长隆海洋王国海底
扬州市文峰小学	扬州市新华中学
广州站附近酒店	广州 站 附近 酒店
Cj	cj
长治五中	长治一中
香港移动	香港中国移动通讯
温岭市职业技术学校	温岭市城北街道
泰山自由行山顶住宿	泰山山顶住宿两日游自由行
希尔顿欢朋酒店贵阳	贵阳希尔顿酒店
松原到长岭	长岭到松原
三亚市海棠湾仁恒皇冠酒店	三亚 市 海棠 湾 仁恒 皇冠 酒店
闵行区东川路	闵行区东川路500号
陡沙河酒店	陡沙河住宿
宜昌重庆三峡游轮	三峡游轮重庆宜昌船票
京都大阪观光一日券	京都大阪观光一日
保定摩登	保定摩登水晶
有浴缸的酒店南宁	南宁有浴缸的酒店
西宁自由行包车	西宁 自由 行 包车
直升机观光	直升机体验
芙蓉镇纯玩	芙蓉镇2日游
象山沙塘湾民宿靠海	象山沙塘湾民宿
泰国spa曼谷当天	泰国曼谷spa
南宁一号公寓	南宁壹号公寓
首尔  送机	首尔接送机
宁波去东极岛	宁波怎么到东极岛
神龙架6日游	神农架6日游
佛山名都	佛山名都大酒店
香港花园酒店	香港花园
博鳌琼海华美达	博鳌琼海华美达豪华套房
苏州观前街汉庭	苏州观前街汉庭酒店
南昌江西省博物馆酒店	南昌江西艺术中心大剧院酒店
古城丽江	丽江古城的酒店
福州市第二中学	福州市第十一中学
、篁岭索道	篁岭门票
Ｋ91	Ｋ 91
上海长途汽车总站	上海长途汽车客运站
厦门大学附近	厦门大学酒店
舟山香格里拉	舟山香格里拉大酒店
慕田峪玩跟团游	慕田峪跟团游
海南三亚跟团游福州出发	福州出发去三亚
深圳北到河源	河源到深圳
北戴河情侣酒店	北戴河情侣
营口市鲅鱼圈经济开发区	营口鲅鱼圈高铁站酒店
东莞下坝坊	东莞下呗坊酒店
取消 旅行 保险	旅行保险
北疆路线	北疆小环线
美国境外流量	美国流量包
合肥约拍	合肥旅拍
东莞酒店公寓	东莞新城公寓
天津一中心医院	天津儿童医院
沈阳工程学院1座	沈阳工程学院
新街访	新街坊
蚌埠玖乐连锁酒店	蚌埠玖乐
庐山二日游九江出发	庐山二日游纯玩豪华九江出发
浙江富阳南国大酒店	富阳南国
南京汤山紫	南京汤山
腾格里沙漠星空露营	腾格里沙漠营地
三亚靠海民宿	三亚观海民宿
嘉兴九龙山庄	嘉兴门票
乌镇附近景点	乌镇景区
大理机场大巴	大理古城到机场
石林峡ufo	石林峡 ufo
杭州肯丁酒店式公寓滨江星光店	肯丁酒店式公寓(杭州滨江店)
无锡市积余实验学校	无锡市侨谊实验中学附近的酒店
长沙长郡中学站附近的酒店	长沙市长郡中学酒店
大理倾城	大理古城倾城别院
惠州出发香港游两日游	香港二日香港
深圳桑拿房	深圳桑拿酒店
沙扒星际酒店	沙 扒 星际 酒店
曼谷火车站怎么去芭提雅	曼谷去芭提雅
南京2号线酒店	南京地铁二号线酒店
青岛科技街酒店	青岛北区酒店
云浮技师学院	云浮中学
饶平到潮汕	潮汕到饶平
小白羊国际青年旅社	小白羊国际青年旅舍
常州去南京	南京去常州
亚航手提行李	亚航行李 补买 选座 捷星 乐桃航空 虎航 越捷 春秋航空 托运行李
丽江古城周边酒店	丽江古镇酒店
长沙岳麓书院攻略	长沙一日游岳麓山
漫心酒店北京四合院	漫心酒店北京前门四合院
义乌商贸城客运中心	义乌国际商贸城四区
海南三亚旅游5天4晚亚特兰蒂斯出海潜水旅行五日游亲子跟团	海南三亚旅游5天4晚亚特兰蒂斯旅行
珠海长隆套票吃住	珠海长隆吃住
海陵岛泳池	海陵岛泳池别墅
龙岩第二医院	龙岩汽车站
稻城攻略	稻城一日
十步海岸	十步
杭州去黄山	杭州黄山跟团两日游
郴州市仙居岭京伦酒店	郴州仙居岭京伦酒店
泉州出发普陀山	泉州普陀山
汉庭优佳海伦路	汉庭 海伦路
西安珍宝馆	西安珍宝馆门票
重庆的酒店南岸区南坪路金子村	重庆酒店南岸南坪路
常德大小河街附近的酒店	常德市步行街附近住宿酒店
如家酒店庆春路钟点	如家酒店庆春路
北部汽车站	北部汽车客运站附近的酒店
蜜月澳大利亚	澳大利亚蜜月游
盐城亭湖新区实验学校	盐城亭湖区
日照海滨森林公园门票	日照东港滨海国家森林公园门票
额济纳跟团游	额济纳三日游
电视机55寸	65寸电视机
张掖的酒店民宿	张掖民宿酒店
青岛普陀山	青岛 普陀山
郑州电影小镇附近的酒店	郑州电影小镇附近
南京十七号客栈（禄口机场店）	南京三十九精品客栈禄口机场店
上海大观园门票学生票	上海大观园大门票
殷巷附近的酒店	殷巷
云南省安宁市云南经济管理学院	云南安宁职教园区
上海迪士尼门票哦哦	上海迪士尼门票快速通行证
桂林自由行两天一晚	桂林两日游纯玩跟团游
大同的酒店火车站	大同火车站酒店
磐安海德	磐安海德酒店
兰兹酒店学府	兰兹酒店东门
富邦国际	富邦
万怡杭州	杭州万怡酒店
温州附二医酒店	温州附属第一医院附近的酒店
平度市人民政府	平度市凤台中学
锦江都城	锦江都城酒店
雪乡滑雪	雪乡滑雪场门票
兰州第五十七中学	兰州第十中学
广州到巫山	巫山至广州
留学签证英国	英国学生签
金沙商务宾馆	金沙宾馆
峨眉山远山云驿	峨眉山远山云驿酒店
阁兰大县	阁兰大
湖泉半山酒店	湖泉半山
爸妈老年跟团游	老年跟团游
古北水镇 3人	古北水镇3人
JW万豪自	jw万豪自助
界宿人文客栈	张家界市界宿人文客栈
苏州圆融时代广场附近的酒店	苏州奥体中心附近的酒店
宁波蒙罗希尔顿	宁波罗蒙希尔顿
广州仲恺农业工程学院白云校区酒店	广州市机电技师学院白云校区
法国签证跟团	法国跟团游签证
长白山机场到二道白河	长白山包车机场二道白河
大理网红美食	大理特色美食
春天连锁宾馆3店	春天连锁宾馆三店
广州拼图酒店	拼图酒店(广州凤凰新村地铁站店)
银川万达广场	银川万达
山东泰安泰山山上民宿	山东泰安泰山民宿
上海及周边游	周边游上海
西安按摩	西安桑拿
株洲市炎陵县神农谷国家森林公园酒店	株洲炎陵神农谷国家森林公园
如家派柏云酒店长沙	长沙如家派柏云酒店
信阳平桥区实验小学酒店	信阳平桥区第二小学酒店
东莞御宝花园酒店	东莞御宝
云南纯玩10天	云南纯玩10日
老君山怎么去	老君山旅游
汕头大学如家酒店	汕头酒店如家
连江一日游自由行	福州连江一日游
上海环游巴士	上海旅游巴士
武汉康辉旅行社	武汉康辉旅游
婺源晚闻堂民宿	婺源景区民宿
梧州市万达广场	广州万达广场
济南遥墙飞机场附近的酒店	济南遥墙飞机场附近宾馆
登巴国际连锁客栈（北京五道口店）	登巴国际连锁客栈北京
重庆万州龙建酒店	重庆万州龙建
东京大阪6日5晚攻略	东京大阪6日5晚一日
福州带浴缸	福州浴缸
北京旅游一天	北京一日游攻略
西海岸隆和艾美度假村	西海岸隆和艾美度假酒店
许昌高铁站东站附近的酒店	许昌北站
旅行团 新疆	新疆旅游纯玩
兴国站	兴国西站
沈阳方特欢夜场	沈阳方特欢乐世界
杭州出发去云南	杭州出发到云南旅游
重庆江北机场到重庆西站	江北机场到重庆北站
金佛山 北坡	金佛山北坡
泰国游攻略	泰国攻略
安徽度假村别墅	安徽 度假 村 别墅
三亚aow潜水	三亚潜水aow
浙江慈溪鸣鹤古镇	慈溪鸣鹤古镇酒店
华清池泡脚	华清池 泡脚
豪香国际大酒店	豪香大酒店
山西大同国旅	山西大同旅
黄山市西递宏村景区	黄山宏村西递歙县
二郎剑景区船票	二郎剑景区
崂山迎口	崂山仰口
临汾一中旁	临汾一中
广州长隆野生动物园大马戏和水上乐园	广州长隆水上乐园大马戏野生动物园
横店颐和	横店颐和酒店
包车往返青岩古镇	青岩古镇包车
北戴河刘庄民宿	秦皇岛北戴河附近住宿刘庄民宿
保定华北电力大学二校区酒店	保定职业技术学院北校区
福州喔弥陀佛饭店	福州阿弥陀佛酒店
黄山白云宾馆住宿加门票	黄山白云宾馆多人间
珠海拱北口岸酒店	珠海市拱北口岸
绍兴 五星酒店 	绍兴五星酒店
长寿湖景区	长寿湖门票
张掖出发敦煌二日游	敦煌张掖二日
重庆万洲五桥	重庆万州五桥
青岛苗岭路(地铁站)酒店	青岛地铁二号线附近酒店
久栖三亚兰海	久栖 三亚兰海度假酒店公寓
沈阳浑南实验中学	沈阳浑南一中酒店
境外流量包o泰国	【东南亚等53国通用】中国移动泰国无限量流量包
泰国 sim	泰国电话卡
灵山小镇拈花湾门票	拈花湾灵山大佛
杭州维多利亚丽嘉	杭州维多利亚丽嘉酒店
郑州非繁·城品酒店	非繁印象酒店郑州
茂名到梅州	梅州到茂名
重庆统景温泉南	重庆统景温泉
观音山水世界	观音山梦幻水世界
石塘竹海 南京	南京石塘竹海
西安市民宿全家	西安民宿二居
石城天沐温泉	石城温泉
江门新会古兜温泉独立温泉	广东江门新会古兜温泉
南宁 特价机票	南宁特价
郑州市公安局	郑州市公安局经侦支队
柏槿酒店深圳东门湖贝	深圳柏槿酒店（湖贝地铁站店）
广州酒店加自助餐	广州酒酒店自助餐
深圳福田汽车站附近三人间酒店	深圳福田汽车站酒店
济南市天桥区	济南市天桥区酒店
L7	l 7
毛里求斯 鸟公园四驱车	毛里求斯鸟公园一日游
香港 电话卡 移动	香港电话卡移动
珠海的酒店长隆附近	珠海长隆海洋馆酒店
遵义云水湾	遵义云水湾度假酒店
汗蒸馆温州	汗蒸温州
张家界森林公园天门山凤凰三天	张家界凤凰3天2晚
普陀山泊客	舟山普陀山泊客民宿
北京交通大学东校区	北京交通大学
东莞塘厦石鼓	东莞塘厦镇石鼓
aurora-story	ustory
拉萨珠峰大本营一日游	拉萨一日游珠峰
重庆喜来登自助餐	重庆万豪自助餐
日本签证1年	日本签证年
阿那亚 	阿那亞
都江堰私汤温泉	都江堰温泉私汤
株洲方特特价	株洲方特
深圳市格兰云天大酒店	深圳格兰云天酒店
鹰潭市月湖区	鹰潭市区酒店
南京三亚自由行往返机票	南京到三亚机票
梁子湖龙弯	梁子湖龙湾
三亚海棠湾呀诺达热带雨林	三亚 呀诺达热带雨林
九江跟团	九江二日游
如家neo城隍庙	如家 城隍庙
郑州火车站附近吃的	火车站郑州
阆中明宇豪雅	阆中明宇尚雅酒店
韩国过境签证青岛	韩国过境签证
韩国 滑雪	滑雪韩国
银座佳驿轻居酒店	银座佳驿
广州长隆飞鸟乐园的门票套票	广州长隆飞鸟乐园的门票
韶关市经律论温泉	韶关经律论温泉票
郴州风吹过轻奢民宿	郴州民宿
上海浦东香格里拉大酒店套房	上海酒店浦东香格里拉
青岛栈桥王子饭店商务海景房	青岛栈桥王子饭店
上海迪斯尼早鸟	上海迪士尼乐园早鸟
江西 庐山	江西庐山
终南山寨住宿	终南山寨
泉州市如家酒店	泉州如家酒店西街
仙本那一日游攻略	一日仙本那
成都特惠机票	成都特价机票
武陵源景区酒店	武陵源的酒店
武汉到宜昌火车票	宜昌到武汉的火车票
神舟租车 石家庄	石家庄轿车租车
兰州麗枫酒店	兰州正宁路丽枫酒店
成都出发九寨沟黄龙三日游	成都到九寨沟黄龙三日游3日游
台湾 签证	入台证台湾
沈阳到保康	保康到沈阳
杭州游跟团四日三晚	杭州四日游
从化太平	广州从化太平
巽寮湾直通车	惠州巽寮湾直通车
动物园。野生	长隆动物世界
国内租车自驾保险	自驾租车国内
桂林漓江豪华三星船	桂林游漓江四星船
宣城国购广场酒店	宣城国购广场附近酒店
上饶县第二中学	上饶第二中学
广州长隆餐厅自助午餐	广州长隆自助餐厅
hello青季	Hello 青季酒店
乌镇三天两夜	乌镇三天两晚
西山风景	西山景区
镇江富力喜来登酒店	镇江喜来登
太原的酒店山西大医院	太原山西大医院
广州附近旅游景点	广州游玩景点
上海锦江之星龙阳路	上海锦江之星酒店长阳路
神女2号	神女1号
胶州市职业教育中心	胶州市初级实验中学
金孔雀	金孔雀酒店
万豪三亚海棠湾万丽酒店	三亚市海棠湾万丽酒店
三明医科	三明中西结合医院
厦门房车露营	厦门露营
上海嘉定江桥万达广场密室	上海嘉定江桥万达广场
西溪的当地玩乐	西溪的门票
绍兴峡谷洞漂流	绍兴峡谷漂流
杭州 滨江希尔顿	滨江希尔顿
岳阳站附近酒店	岳阳站
济宁附属医院	济宁市第一人民医院
临汾新一中(高中部)	临汾新华中学
龙出没漂流南京	南京熊出没漂流
广州金融城绿地中心酒店	广州绿地中央广场
鱼唐	鱼唐酒店
厦门世茂双子塔全部	厦门金玉海景酒店公寓
轻型婴儿车	婴儿车
东莞市谢岗镇凯信酒店	东莞凯信酒店
熊猫跳伞海口基地	海口熊猫跳伞
坐邮轮冲绳一日游	冲绳一日邮轮
南宁锦江之星江	南宁地铁站锦江之星
十一国庆节旅游	十一国庆旅游
苏州园外楼	苏州楼外楼
重庆隔离酒店	重庆定点隔离酒店
尼玛县	尼玛县大酒店
江门恩平恒大泉都温泉门票	江门恩平恒大温泉
北京故宫博物馆	北京故宫
环球洲际大饭店	环球洲际酒店
护照韩国	个人护照办理韩国
机场贵宾厅深圳	机场vip贵宾休息室深圳
莫干山山顶	莫干山风景名胜区
云南师范大学商学院	云南经济管理学院
梅州丰顺鹿湖温泉酒店自助	梅州丰顺鹿湖温泉酒店
南昌市南昌昌北国际机场酒店	南昌昌北国际机场附近的酒店包接送
毕棚构门票	毕棚门票
西岭雪山 那	西岭雪山垚垚
鲁山滑雪场	鲁山滑雪
洛阳一广州飞机要	广州到洛阳飞机
上海迪士尼游玩路线	上海迪士尼游玩
深圳尚客优快酒店	深圳尚客优酒店
熊猫酒店3天	熊猫酒店3天2晚套票
大理古城至双廊	大理古城去双廊
郑州到南阳高铁票	郑州到南阳高铁
张家界旅游定制	张家界定制游
上海萨维尔金爵鹿安酒店迪士尼	上海萨维尔金爵·鹿安酒店
曲阜师范大学酒店	曲阜师范大学
东北老年团跟团游5天	东北老年团跟团游
杭州野生动物园世界	杭州野生动物园
广州偶来民宿（珠江新城店）	广州偶来民宿
廊坊十中	廊坊第一中学
乾汤温泉	乾汤国际温泉
南通叠石桥家纺城附近的酒店	南通叠石桥
郴州小东江3日游	郴州小东江三天两夜自由行
广州长隆酒店动物园大马戏白虎餐厅	广州长隆酒店动物园大马戏套餐
苏州无二空间	苏州无二空间设计艺术酒店
阳光保利海陵岛皇冠假日酒店	阳江海陵岛保利皇冠假日酒店
芜湖方特大白鲸海洋公园	芜湖方特梦幻王国 大白鲸
云南旅游跟团重庆出发	云南旅游重庆出发
崇仁县的酒店	江西崇仁县
东航VIP休息室	东航贵宾休息室
茵特拉根溫泉酒店	东部华侨城茵特拉根温泉酒店套票
夏门鹭江酒店	厦门鹭江·佲家酒店
台湾垦丁	垦丁旅游
拉木措两日游	纳木措两日游
方特大同门票	大同方特欢乐世界的通票门票
福建林业职业技术学院江南校区	福建林业职业技术学院(江南校区)
白云机场送机包车	白云机场送机
花水湾艾美达酒店	花水湾艾美达
厦门到松溪	松溪到厦门
天津滨海锦江	天津锦江之星旅馆-鼓楼店
重庆武汉	武汉 重庆
去云南吧香格里拉大理丽江玉龙雪山	云南旅游丽江香格里拉玉龙雪山
深圳城市精选酒店	深圳城市精品酒店
西国贸水会	西国贸水会酒店
大理松果里海景庭院别墅	大理松果里海景庭院
墨尔本到香港	香港到墨尔本
氡泉温泉花园	花园温泉
全季酒店杭州文三路	全季酒店 杭州东站
深圳轮船游	深圳游轮游
广州洛克维国际公寓酒店	广州克洛维国际复式公寓
游轮旅行深圳出发	深圳上海出发邮轮
公务舱套票	公务舱特价
上海快乐盒子服务式公寓	上海快乐盒子公寓
潮汕牛肉火锅	潮汕牛肉丸
银川海底世界	银川海洋馆
大连香洲温泉酒店	大连香洲温泉度假区
上海迪士尼快速通行证通道	上海迪士尼快速通行证
杭州民宿独栋	杭州民宿整栋
上诲迪士尼一日游	一日游上海迪士尼
海口海南金色阳光温泉度假酒店	海口金色阳光温泉度假酒店
徐州市徐州火车站酒店	徐州市徐州站酒店
珠海长隆鲸鲨馆餐厅	珠海长隆鲸鲨馆
浙江省内旅游	省内游浙江
武侯祠大街	武侯祠附近酒店
深圳国际会展中心如家	深圳的如家酒店
武昌区的酒店	武昌区住宿
纯玩重庆	纯 玩 重庆
珠海长马戏酒店自助晚餐	珠海长隆马戏酒店自助晚餐
跟团游从化	从化车票
宜必思酒店南京南	南京宜必思尚品
一日游	一日游小团
清远族游	清远旅游
香港旅游自由行一日	香港自由行一日
广州长隆国际大马戏酒店套票	广州长隆国际大马戏门票双人
海拉尔车站酒店	海拉尔火车站
jen酒店	Jen
青海湖二日游	青海湖两日
里橙酒店	里橙酒店五一路
汉庭海伦路	汉庭优佳海伦路
平安金融中心观光	平安金融中心观光层门票
昆明南高铁站	昆明南站高铁站附近酒店
天台国清寺附近酒店	台州天台国清寺酒店
花居酒店苏州	苏州花居酒店
哈尔滨体育学院附近的酒店	哈尔滨工业大学二校区附近酒店
广州出发到惠州	惠州到广东
南京东路美食	南京东路自助晚餐
贵州雷山县千户苗寨住宿	雷山县苗宿精品客栈
花水湾温泉别墅	花水湾温泉度假别墅
比斯特购物村	比斯特购物村一日游
嵊泗船票车渡	嵊泗车船票
爱蹦蹦床运动馆	蹦床馆
兰州机场休息室	兰州机场vip贵宾休息室
日本冲绳一日包车	冲绳包车自由行
都江堰熊猫驿站酒店	都江堰熊猫驿站文化酒店
阿尔罕布拉宫大门票	阿尔罕布拉宫-大门票
珠海市斗门区乾务镇	珠海斗门区乾务镇附近的酒店
广东市	广东 市
辽阳碧湖温泉度假村 汤屋	辽阳碧湖温泉度假村
花莲 台东一日游	花莲台东
河南省民族中等专业学校	河南省交通职业技术学院
南京拉汤屋	南京汤屋
天空岛蒸汽火车高品质	天空岛蒸汽火车
大连甘井子区	大连甘井子区酒店
上海惠南地铁站	上海惠南(地铁站)酒店
湛江西到广州的火车票	湛江西到广州高铁
自助餐开封	开封喜来登自助餐
遵义铂尔顿酒店	遵义希尔顿花园酒店
福家快捷宾馆	福家商务宾馆
交通卡 曼谷	曼谷bts轻轨
三亚南山寺千古情一日游	三亚南山寺千古情
福州第一中学	福州第十一中学
厦门鼓浪屿怎么样	鼓浪屿三天
威海景区门票	威海景区
首尔 韩村	首尔韩屋村
长沙亲子乐园	长沙儿童乐园
去雕门岛	雕门岛
珠海长隆海洋王国门票酒店套票	珠海长隆海洋王国门票双人票
扬州北湖湿地公园	扬州湿地公园
山东中医药大学老校区	山东医药技师学院
江浙四日游	江浙沪旅行团四天三夜
东海岸白沙滩度假酒店	东海岸白沙度假酒店
7天连锁酒店成都世纪新城新会展中心店	7天连锁酒店成都世纪城新会展中心店
本溪水洞附近住宿，，	本溪水洞附近酒店
海陵岛两室一厅	海陵岛四房公寓
运城中学	运城学院
珠海技师学院	珠海城市职业技术学院附近酒店
玛雅海上公园	玛雅水上公园
深圳观澜山水田园水上乐园	深圳观澜山水田园门票
东莞虎门白沙高铁站酒店	东莞虎门白沙
福州到平潭包车	福州平潭岛包车
张家界的民宿	张家界市区民宿
八达通卡香港机场取	香港机场八达通卡
宁德周宁县酒店	宁德周宁县宾馆
云南丽江4日3晚游	云南丽江4日
上海东方绿洲门票儿童票	上海东方绿洲门票团购
家用暖风机	电暖器
保定市满城神湖滑雪场	保定市满城神湖滑雪
丽水租车公司	丽水租车
普者黑南云艺舍民宿	普者黑精品南云艺舍民宿
重庆武隆仙女镇酒店	重庆武隆仙女山景区内酒店
潜庐乡居	潜庐
杜莎夫人蜡像馆几点开门	上海杜莎夫人蜡像馆
成都滑雪一日游	滑雪一日游成都
泊屿	屿泊
怡莱苏州相城大道酒店	怡莱酒店苏州
长隆旅游度假区附近酒店	长隆旅游度假区附近的酒店
贵阳出发两日游	贵阳跟团2日游纯玩
志诚丽柏	志诚丽柏酒店
贵阳到郑州高铁	贵阳到郑州
三亚亚龙湾凯莱仙人掌度假酒店3大1小	三亚亚龙湾凯莱仙人掌度假酒店
阳朔西陈家花园	阳朔陈家花园西街店
上海迪斯尼附近酒店	上海迪士尼附近酒店
温泉 	温泉  
京津新城凯悦酒店	京津新城凯悦大酒店
宁夏周边游	宁夏
广州四季酒店自助	广州四季酒店
抚仙湖 太阳山	抚仙湖太阳山度假酒店别墅
仙本那跳岛游 深潜	仙本那跳岛深潜
苏州到上海迪士尼	苏州到迪士尼
甲米七岛一日游	甲米七岛游
新余到九江	九江到新余
佛山市第二人民医院	佛山市中医院
鹤庆新华村	鹤庆县新华村
绵阳 酒店	绵阳的酒店
温泉 安徽	温泉安徽
马达加斯加	马达加斯加岛
宁波南苑饭店联丰中路	南苑e家精选酒店（宁波古玩城店）
庐山景区	庐山风景名胜区
摩洛哥当地	摩洛哥一日
大阪环球影城 游行	大阪环球行影城
上海去宁波	宁波至上海旅游
一日意外险	一天意外险
桃村北	桃村北站
洲际券	洲际通兑券
秦皇岛北戴河果果民宿	北戴河果果民宿
小叮当	小叮当酒店
三亚最大商场	三亚大商场
珠海市拱北城轨站	珠海拱北口岸轻轨站酒店
东京迪士尼双人	东京迪士尼乐园
塘沽如家	如家塘沽
厦门曾垵厝海民宿	厦门曾垵厝海景民宿
北京乐盟酒店	北京乐盟
上海迪士尼乐园三天两晚	上海迪士尼三天两夜
挪威瑞典	挪威 瑞典
南京夫子庙自	南京夫子庙
南澳县青澳湾艺墅度假酒店	南澳县青澳湾酒店
黄山景区民宿	黄山风景区民宿
洛阳克丽司汀	克丽司汀洛阳
双子座民宿	双子座名宿
张家界玻璃栈道。	张家界玻璃桥
万县的酒重庆万州酒店	重庆万州酒店
暑假自驾游海南	自驾游海南
上海迪士尼乐园附近酒店民宿拾园	上海迪士尼乐园酒店民宿
上海天文馆附近的酒店	上海自然博物馆附近的酒店
上海野生动物园门票家庭票	上海野生动物园儿童票
虎跳峡半山秘境	虎跳峡半山
龙口南山大佛	龙口南山大佛门票
如家上海科苑路	上海路如家
青岛 公寓	青岛公寓酒店
儿童要大阪周游卡吗	大阪周游卡儿童
福州东湖万豪酒店酒店套餐	福州东湖万豪
海南热带动物园	海南动物园
珠海长隆迎海酒店公寓套票	珠海长隆迎海
莫干山度假酒店	莫干山度假村
微恋酒店	微恋
度假区万怡	国际旅游度假区万怡酒店
哈尔滨旅游旅游攻略	哈尔滨一日
京津附近两日游	北京二日
青岛如家酒店崂山会展中心	青岛黄岛区如家酒店
临安湍口众安氡温泉酒店	临安湍口众安氡温泉度假酒店自助餐
美居酒店苏州	美居苏州
北京有什么可以玩的	北京有什么好玩的地方
兵马俑语音讲解	讲解兵马俑
宿适轻奢酒店上海南站店	宿适轻奢酒店(上海南站店)
邯郸成安宾馆	邯郸成安广电商务宾馆
K205火车	205火车
和院静筑拾光酒店	和院静筑拾光
青岛青旅国际	青岛国际青年旅社
连云港苏宁广场(通灌北路)酒店	连云港市连云港苏宁广场酒店
九寨沟县	九寨沟
郑州到拉萨的机票	拉萨到郑州的机票
惠州华润小径湾无敌海景房	惠州小径湾海景房
彭山区	彭山区的酒店
波士顿游	波士顿 游
新华宾馆 布达拉宫店	拉萨新华宾馆 布达拉宫店
喆啡酒店邯郸大剧院高铁站店	邯郸喆啡酒店
小迳湾艾美	小径湾艾美
崂山住宿	崂山附近酒店
龙湾万达广场	龙湾万达酒店
首页搜丽江后乐设计师轻奢民宿明天天入住流量做最便宜的	丽江后乐设计师轻奢民宿
汉庭静安寺店	汉庭酒店静安寺
艾美酒店南宁教育路	南宁 艾美
浙江仙居	浙江台州仙居
天津怎么坐地铁	天津地铁
芭提雅拉别墅	芭提雅芭提雅别墅
汕头一中新校区	汕头中旅客运站附近的酒店
兰州中川机场贵宾室	兰州机场贵宾厅
无锡清名桥古运河船票	无锡清名桥古运河
嘉兴的	嘉兴
朱熹纪念馆	朱熹公园
广州广东科贸职业学院白云	广州市广东白云学院
锦里沟泡泡	锦里沟泡泡屋
北京市海洋馆	北京动物园海洋馆
济洲岛泳池	济州岛泳池
驿路港湾宾馆	驿路港湾快捷酒店
长春吉林大学白求恩第一医院酒店	长春市吉林大路酒店
常熟如家商旅酒店	常熟如家
长沙五一广场亲子房	长沙五一广场亲子酒店
清研莫干山精品民宿	民宿莫干山
王城精品酒店	王城精品
成都瓦当舍瓦	成都瓦当瓦舍
西安陕西师范大学雁塔校区酒店	西安建筑科技大学雁塔校区酒店
深圳蛇口汽车站	深圳蛇口人民医院
兰州甘肃旅游	兰州跟团
合肥市肥东县酒店	合肥肥东县城关中学酒店
杭州西湖步行街民宿客栈	杭州西湖东侧酒店民宿
大同大有广场酒店	大同市大有广场酒店
四川幼儿师范高等专科学校西校区	四川商务职业学院
武汉纽宾凯尚居	武汉纽宾凯尚居酒店
上海迪士尼门票要多少元？	上海迪士尼门票
宏村老房子国际青年旅舍	宏村青年旅社
无锡包车接送	包车无锡
鹰潭	江西鹰潭
河南滑翔伞	滑翔伞河南
贵阳夏日康桥酒店	贵阳夏日康桥酒店（白云公园欢乐世界店）
海南三亚两日游	海南三亚旅游两日游
西安到成都高铁票	成都至西安高铁
燕岛薇薇商务宾馆	薇薇商务宾馆
甘南壮族自治州	甘肃甘南藏族自治州
珠海长隆套餐详情	珠海套餐长隆
华山二日游	华山2日游
宽甸县	宽甸住宿
珠海机场去澳门	珠海机场接送澳门
洛阳白云山两日游攻略	洛阳白云山两日游
开封汴京兰台精品酒店	开封兰台酒店
九江市濂溪区第一中学酒店	九江职业大学濂溪区酒店
芜湖安徽商贸职业技术学院酒店	芜湖安徽机电职业技术学院酒店
丽江丰泽居客栈	丽江润泽居精品客栈
南宁九曲湾温泉度假村	南宁九曲湾温泉谷
曼谷如何去清迈	曼谷去清迈
大理三日游	大理三天
上海浦东辅特	上海浦东辅特戴斯酒店新国际博览中心店
新昌到杭州的汽车票	杭州到新昌汽车票
厦门曾厝垵住宿	厦门附近的酒店
延安出发壳口瀑布一日游	延安壶口瀑布一日
莱芜长途汽车站附近的酒店	莱芜职业技术学院附近的酒店
上海虹桥到新郑	新郑到虹桥
贵州东景希尔顿	贵州 希尔顿
石家庄中铁大厦	石家庄中铁
开封铁塔	开封铁塔景区
浙江象山影视城	象山影视城
南京六合区如家酒店	如家酒店南京六合店
西安出发3日游	西安三日
苗韵度假酒店	苗韵
香港电话卡1月	香港1电话卡
普吉岛 考证	潜水普吉岛ow
银川火车站新华联附近酒店	银川火车站附近酒店
环球魔幻世界	环球魔幻城
国际航班行李额	首航行李额购买
遂溪县	遂溪县第一中学
君宜王朝大饭店	君宜王朝大酒店
肇庆鼎湖山景区	肇庆鼎湖山酒店
上海韩国亲子游	亲子韩国游
绵阳的七天连锁酒店	7天连锁酒店绵阳安昌桥店
青岛接站服务专	青岛接站服务
宜必思尚品成都春熙路步行街酒店	宜必思成都
长江总统游轮	长江豪华游轮
宁波飞马尔代夫	飞马尔代夫
大理小团	大理旅游小团
奔驰e级	奔驰e
pp岛 大小	大小皮皮
御峰酒店	御峰
广州荔湾区人民医院附近的酒店	广州荔城街第三中学酒店
熊猫繁育研究基地学生票	大熊猫繁育研究基地
武功山君澜温泉	武功山温泉君澜度假酒店套票
长春机场接送机	长春机场接送
斯里兰卡自由行全部	自由行斯里兰卡
天堂寨八湾塘	天堂寨八湾堂
宾果公寓	宾果酒店式公寓
全季酒店虹桥机场	虹桥机场 全季
海口市锦江之星酒店	锦江之星酒店海口
长春沈阳东京自由行	长春东京自由行
青城山花郡度假别墅	青城山泳池别墅
资阳雁江七小酒店	资阳市雁江七小
eha电竞	eha电竞酒店
上海世贸洲际	洲际酒店上海
大连星海公园附近的民宿	大连北站附近民宿
长治市实验中学	长治市汽车客运东站附近的酒店
江西婺源李坑民宿	婺源李坑民宿
汉庭优佳百子湾	汉庭百子湾
贵阳东站附近景点	贵阳北站附近的景点
富士山 两日	富士山两日游
西塘文化节	西塘的门票
合肥安徽医科大学本部酒店	合肥安徽医科大学酒店
罗马梵蒂岗博物馆门票	梵蒂岗博物馆门票免排队
扬州极地海底世界	扬州极地海洋世界
青岛五一攻略	青岛旅游。
芭提雅central point	芭提雅central
玉林雅斯特酒店	雅斯特酒店玉林文化广场店
凯恩斯天空之城萤火虫	凯恩斯萤火虫
重庆两江夜游轮船	重庆重庆两江夜游船票
武汉到嘉善	嘉善到武汉
北京西到廊坊	北京南到廊坊
汕尾 希尔顿	汕尾希尔顿
中晶	中晶酒店
杭州3晚	杭州酒店2晚
狼牙山万亩花海	狼牙山万亩花海门票
合肥淮海路	合肥淮海路步行街
喀什国际青年旅舍	喀什青年旅舍
杭州江南大道酒店	杭州东信大道酒店
黄山四天	黄山4天3晚
亚龙湾潜水一日游	三亚亚龙湾潜水一日游
参团游	参团
汉庭酒店哈尔滨火车站店	汉庭哈尔滨学府路酒店
天目大峡谷附近漂流	天目溪漂流
车辆保险	车险
骏怡	骏怡酒店
郑州自由行3天2晚含机票	郑州3天
微客酒店	微客➕
拙政园狮子林	苏州拙政园狮子林门票
北京清河火车站	北京清河站
四川成都稻城亚丁	稻城亚丁成都
余温泉山庄	温泉山庄
日本迪士尼海洋	日本迪士尼海洋乐园门票
上虞富丽华	上虞富丽华大酒店
维纳斯皇家温泉度假酒店\n\n	维纳斯皇家温泉酒店
挪威罗弗敦	挪威罗弗敦群岛
中国恐龙园	中华恐龙园门票
番禺游泳池	番禺度假酒店
黄河入海口风景区	黄河入海口门票
三亚 海棠湾 别墅	三亚海棠湾独栋泳池别墅
普吉岛katathani	普吉岛katathani酒店
邯郸四中附近的酒店	邯郸二中新校区酒店
虎牙门票	虎牙一日
厦门隐舍轻奢海景度假酒店	厦门隐舍轻奢海景度假客栈
永州植物园	永州 植物 园
